African|африканец, африканский|'xfrIkqn
American|американец, американский|q'merIkqn
April|апрель|'eIpr(q)l
Arab|араб|'xrqb
Atlantic|атлантический|qt'lxntIk
August|август|O:'gAst
Australian|австралийский|O'streIlIqn
BBC|Британская радиовещательная корпорация|
BMA|Британская медицинская ассоциация|
British|британский|'brItIS
Buddhist|буддист|
Catholic|католик|'kxTqlIk
Chinese|китаец, китайский|'tSaI'ni:z
Christian|христианин|'krIstSqn
Christmas|рождество|'krIsmqs
December|декабрь|dI'sembq
Duke|герцог|dju:k
English|английский|'INglIS
Ethiopian|эфиоп, эфиопский|,i:TI'qupjqn
European|европейский|,juqrq'pIqn
February|февраль|'februqrI
Friday|пятница|'fraIdI
German|немец, немецкий|'dZq:mqn
Greek|греческий|gri:k
I|я|aI
IRA (Irish Republican Army)|Ирландская республиканская армия|
Irish|ирландский|'aIqrIS
January|январь|'dZxnjuqrI
Jewish|еврейский|'dZu:IS
July|июль|dZu(:)'laI
June|июнь|dZu:n
Lord|лорд|lO:d
MP|член парламента (от Member of Parliament)|
March|март|mQ:tS
May|май|meI
Miss|мисс|mIs
Miss (Ms.)|мисс, девушка|
Missis (Mrs.)|миссис, госпожа|
Mister (Mr.)|мистер, господин|
Monday|понедельник|'mAndI
National Leberation Front|Национальный фронт освобождения|
Navy|морской флот|'neIvI
Nazi|нацист|'nQ:tsI
North|север|nO:T
November|ноябрь|nqu'vembq
October|октябрь|Ok'tqubq
Olympic|олимпийский|qu'lImpIk
Pope|Папа Римский|pqup
Portuguese|португальский|,pO:tju'gi:z
Queen|королева|kwi:n
Russian|русский, русский язык|'rASn
Saturday|суббота|'sxtqdI
Scottish|шотландский|'skOtIS
September|сентябрь|sqp'tembq
South|юг|sauT
Spanish|испанский|'spxnIS
Sunday|воскресенье|'sAndI
TV|телевидение|
Thursday|четверг|'Tq:zdI
Tory|тори, консерватор|'tO:rI
Tuesday|вторник|'tju:zdI
Turkish|турецкий|'tq:kIS
University|университет|,ju:nI'vq:sItI
Vietnamese|вьетнамец|
Wednesday|среда|'wenzdI
West|запад|west
a|неопределенный артикль, один|eI
abandon|отказываться, покидать, прекращать|q'bxndqn
ability|способность|q'bIlItI
able|умелый|'eIbl
aboard|на борту|q'bO:d
abolition|отмена|,xbqu'lIS(q)n
abortion|аборт, неудача|q'bO:S(q)n
about|вокруг, кругом, около,  приблизительно|q'baut
above|над, выше, более, наверх|q'bAv
abroad|за границей|q'brO:d
absence|отсутствие|'xbsqns
absolute|полный, абсолютный|'xbsqlu:t
absolutely|абсолютно, совершенно|'xbsqlu:tlI
academy|академия|q'kxdqmI
accept|принимать, допускать|qk'sept
acceptance|принятие, признание|qk'septqns
access|доступ|'xkses
accident|несчастный случай|'xksIdqnt
accommodation|удобство, согласование|q,kOmq'deIS(q)n
accompany|сопровождать|q'kAmpqnI
according|соответственно, в соответствии|q'kO:dIN
account|отчет, мнение, основание, объяснять|q'kaunt
accurate|точный, правильный|'xkjurIt
accuse|обвинять|q'kju:z
achieve|достигать|q'tSi:v
achievement|достижение|q'tSi:vmqnt
acknowledge|признавать, выражать благодарность|qk'nOlIdZ
acquire|приобретать|q'kwaIq
across|через, по ту сторону|q'krOs
act|действие, поступок, действовать, исполнять|xkt
action|действие, деятельность|'xkS(q)n
active|активный, действующий|'xktIv
activity|деятельность, действия|xk'tIvItI
actor|актер, деятель|'xktq
actual|фактический, актуальный|'xktSuql
actually|фактически, в настоящее время|'xktSuqlI
add|прибавлять, добавлять|xd
addition|прибавление, дополнение|q'dIS(q)n
additional|дополнительный|q'dISqnl
address|адрес, обращение|q'dres
adequate|достаточный, соответствующий|'xdIkwIt
administration|управление, администрация|qd,mInIs'treIS(q)n
administrative|административный|qd'mInIstrqtIv
admission|вход, признание, допущение|qd'mIS(q)n
admit|признавать, допускать|qd'mIt
adopt|принимать, присваивать|q'dOpt
advance|продвижение, наступление, продвигаться, наступать|qd'vQ:ns
advanced|передовой, прогрессивный|qd'vQ:nst
advantage|преимущество, выгода|qd'vQ:ntIdZ
advertise|помещать объявление, рекламировать|'xdvqtaIz
advice|совет|qd'vaIs
advisory|совещательный, консультативный|qd'vaIzqrI
advocate|отстаивать, защищать|'xdvqkeIt
affair|дело|q'fFq
affect|влиять, трогать, вредить|q'fekt
afford|позволить себе|q'fO:d
after|после того как, через, спустя, затем|'Q:ftq
afternoon|время после полудня|'Q:ftq'nu:n
afterwards|впоследствии|'Q:ftqwqdz
again|снова, к тому же|q'gen
against|против|q'genst
age|возраст, век|eIdZ
aged|старый, в возрасте|'eIdZId
agency|агентство|'eIdZqnsI
agent|агент|'eIdZqnt
ago|тому назад|q'gqu
agree|соглашаться, согласовываться|q'gri:
agreement|соглашение, согласие|q'gri:mqnt
agricultural|сельскохозяйственный|,xgrI'kAltSqrql
agriculture|сельское хозяйство|'xgrIkAltSq
ahead|вперед|q'hed
aim|стремиться, иметь в виду, цель|eIm
air|воздух, обстановка|Fq
aircraft|самолет, летательный аппарат|'FqkrQ:ft
airline|авиалиния|'FqlaIn
airport|аэропорт|'FqpO:t
airways|воздушные линии|
all|весь, целый, все|O:l
allegation|утверждение|,xlI'geIS(q)n
allege|утверждать, заявлять|q'ledZ
alliance|союз|q'laIqns
allow|позволять, разрешать|q'lau
allowance|скидка, пособие|q'lauqns
ally|вступать в союз|'xlaI
almost|почти|'O:lmqust
alone|один|q'lqun
along|дальше, с, по|q'lON
already|уже|O:l'redI
also|также, тоже|'O:lsqu
alter|изменять|'O:ltq
alternative|альтернатива, альтернативный|O:l'tq:nqtIv
although|несмотря на то, что|O:l'Dqu
altogether|вполне, в общем|,O:ltq'geDq
always|всегда|'O:lwqz
amalgamated|соединенный, объединенный|q'mxlgqmeItId
amateur|любитель|'xmqtq(:)
ambassador|посол|xm'bxsqdq
ambulance|санитарная машина|'xmbjulqns
amend|изменять к лучшему|q'mend
amendment|поправка|q'mendmqnt
amnesty|амнистия|'xmnIstI
among|среди, между|q'mAN
amount|количество, сумма, составлять, достигать|q'maunt
analyst|аналитик, комментатор|'xnqlIst
analyze|анализировать|
ancient|древний|'eInS(q)nt
and|к тому же, а|xnd
anger|гнев|'xNgq
angry|сердитый, гневный|'xNgrI
animal|животное|'xnImql
announce|объявлять, извещать|q'nauns
announcement|объявление, сообщение|q'naunsmqnt
another|другой, еще|q'nADq
answer|ответ, отвечать, соответствовать|'Q:nsq
anticipate|предвидеть|xn'tIsIpeIt
anxious|беспокойный|'xNkSqs
any|какой-либо, сколько-нибудь, еще|'enI
anyone|кто-нибудь, любой|'enIwAn
anything|что-нибудь|'enITIN
apart|в стороне, отдельно|q'pQ:t
apex|верхушка, вершина|'eIpeks
apparent|видимый, явный|q'pxrqnt
apparently|явно, очевидно|q'pxrqntlI
appeal|взывать, просить, апелляция|q'pi:l
appear|появляться, казаться, представляться|q'pIq
appearance|внешность, появление|q'pIqrqns
application|заявление, применение|,xplI'keIS(q)n
apply|просить, применять|q'plaI
appoint|назначать|q'pOInt
appointment|назначение, должность, встреча|q'pOIntmqnt
approach|приближаться, подходить, подход|q'prqutS
appropriate|подходящий, соответствующий|q'prquprIeIt
approval|одобрение|q'pru:vql
approve|одобрять, утверждать|q'pru:v
arbitration|арбитраж|,Q:bI'treIS(q)n
archbishop|архиепископ|'Q:tS'bISqp
area|площадь, район|'FqrIq
argue|спорить, аргументировать|'Q:gju:
argument|довод, спор|'Q:gjumqnt
arise|возникать, появляться|q'raIz
armed|вооруженный|Q:md
arms|оружие|Q:ms
army|армия|'Q:mI
around|кругом, вокруг|q'raund
arouse|будить, пробуждать|q'rauz
arrange|приводить в порядок|q'reIndZ
arrangement|приведение в порядок, договоренность|q'reIndZmqnt
arrest|арест, арестовывать|q'rest
arrival|приезд, прибытие|q'raIvql
arrive|прибывать, приезжать|q'raIv
arsenal|арсенал|'Q:sInl
art|искусство|Q:t
article|пункт, статья|'Q:tIkl
artist|художник|'Q:tIst
as|когда, как, какой, в то время как|xz
ask|спрашивать, просить|Q:sk
aspect|вид, аспект, точка зрения|'xspekt
assault|нападать, нападение|q'sO:lt
assembly|собрание, ассамблея|q'semblI
assert|утверждать, заявлять|q'sq:t
assist|помогать|q'sIst
assistance|помощь|q'sIstqns
assistant|помощник|q'sIstqnt
associate|соединять, присоединять|q'squSIeIt
associated|объединенный, ассоциированный|q'squSIeItId
association|ассоциация|q,squsI'eIS(q)n
assume|предполагать, брать|q'sju:m
assurance|заверение, уверенность|q'Suqrqns
assure|уверять, обеспечивать|q'Suq
assured|уверенный, гарантированный|q'Suqd
at|у, около,  в, к, до, при, по, за, с|xt
atmosphere|атмосфера|'xtmqsfIq
atomic|атомный|q'tOmIk
attach|связываться, приписывать, придавать|q'txtS
attack|нападать, поражать, нападение|q'txk
attempt|попытка, пытаться, покушение|q'tempt
attend|присутствовать, уделять внимание|q'tend
attendance|присутствие, аудитория|q'tendqns
attention|внимание, забота, уход|q'tenS(q)n
attitude|отношение, положение|'xtItju:d
attorney|адвокат, поверенный|q'tq:nI
attract|привлекать|q'trxkt
attractive|притягательный, привлекательный|q'trxktIv
audience|аудитория, слушание дела|'O:djqns
author|автор|'O:Tq
authority|власть, полномочие, управление|O:'TOrItI
autumn|осень|'O:tqm
available|доступный|q'veIlqbl
avenue|авеню|'xvInju:
average|средний, составлять в среднем|'xvqrIdZ
aviation|авиация|,eIvI'eIS(q)n
avoid|избегать|q'vOId
award|награда, присуждать, награждать|q'wO:d
aware|сознающий|q'wFq
away|прочь, неловкий|q'weI
baby|ребенок, младенец, малыш|'beIbI
back|спина, обратный, поддерживать|bxk
background|задний план|'bxkgraund
bad|плохой, неблагоприятный, неудачный|bxd
badly|плохо, очень сильно|'bxdlI
baffle|озадачивать, мешать|'bxfl
balance|равновесие, балансировать, взвешивать|'bxlqns
ball|шар, мяч|bO:l
ballet|балет|'bxleI
ballot|избирательный бюллетень, голосование, голосовать|'bxlqt
ban|запрещать|bxn
band|лента, связь|bxnd
bank|банк, мель, берег|bxNk
banker|банкир|'bxNkq
banking|банковское дело|'bxNkIN
banner|знамя, флаг|'bxnq
bar|бар, брусок, препятствовать|bQ:
bargain|сделка, договариваться|'bQ:gIn
base|основа, базировать, основывать|beIs
baseball|бейсбол|'beIsbO:l
basic|основной, элементарный|'beIsIk
basically|в основном|'beIsIkqlI
basis|основа, основание|'beIsIs
bat|бить|bxt
battle|битва, борьба, сражаться|'bxtl
be|быть, находиться, происходить|bI
bear|переносить, перевозить, нести|bFq
beautiful|прекрасный, красивый|'bju:tqful
beauty|красота, красавица|'bju:tI
because|потому что, так как|bI'kOz
become|становиться, делаться|bI'kAm
bed|кровать, постель|bed
bedroom|спальня|'bedru(:)m
before|до, раньше, перед|bI'fO:
begin|начинать|bI'gIn
beginning|начало|bI'gInIN
behaviour|поведение, манеры|bI'heIvjq
behind|за, позади, сзади|bI'haInd
belief|вера, доверие|bI'li:f
believe|верить, доверять, считать|bI'li:v
belong|принадлежать, относиться|bI'lON
below|внизу, ниже, под|bI'lqu
belt|пояс|belt
bench|скамья|bentS
besides|кроме того, также|bI'saIdz
bet|держать пари|bet
between|между, посреди|bI'twi:n
beyond|вдали, на расстоянии|bI'jOnd
bid|предлагать цену|bId
big|большой, крупный, значительный|bIg
bill|счет, список|bIl
billion|биллион, миллиард|'bIljqn
bind|связывать, ограничивать|baInd
birth|рождение, происхождение|bq:T
birthday|день рождения|'bq:TdeI
bishop|епископ|'bISqp
bit|кусок, небольшое количество|bIt
bitter|горький, сильный, резкий|'bItq
bitterly|горько, сильно|'bItqlI
blast|взрыв, взрывать, разрушать|blQ:st
block|блок, квартал, преграда|blOk
board|доска, стол, борт, правление, совет|bO:d
boat|лодка, судно, корабль|bqut
body|тело, группа людей|'bOdI
bomb|бомба, бомбить|bOm
bonus|бонус, премия|'bqunqs
book|книга, записывать, заказывать заранее|buk
bookmaker|букмекер|
borough|городок, населенный пункт|'bArq
boss|босс, хозяин|bOs
both|оба, и тот и другой, тоже|bquT
bottom|дно, низ|'bOtqm
box|коробка, ящик, ложа|bOks
boy|мальчик, парень|bOI
branch|отрасль|brQ:ntS
bread|хлеб|bred
break|ломать, разбивать, нарушать|breIk
breakaway|отход, отрыв|'breIkqweI
breakdown|поломка, нарушение движения|'breIkdaun
breaking|поломка, разрушение|'breIkIN
brief|короткий, недолгий, краткий|bri:f
bright|яркий, светлый, способный|braIt
bring|приносить, привозить|brIN
broad|широкий|brO:d
broadcasting|радиовещание|'brO:dkQ:stIN
broker|брокер, маклер|'brqukq
brother|брат|'brADq
budget|бюджет|'bAdZIt
build|строить, создавать|bIld
builder|строитель|'bIldq
building|здание, строительство|'bIldIN
burden|груз, бремя|'bq:dn
bureau|бюро|bjuq'rqu
burn|сжигать, гореть|bq:n
bury|хоронить, погружать|'berI
business|дело, бизнес|'bIzInIs
businessman|бизнесмен|
but|наружу, снаружи, кроме|bAt
butler|дворецкий|'bAtlq
buy|покупать|baI
buyer|покупатель|'baIq
by|у, около, рядом, вдоль, по, на|baI
by-election|дополнительные выборы|'baII,lekSqn
cabinet|кабинет|'kxbInIt
cable|кабель, телеграмма|'keIbl
calculate|вычислять, рассчитывать|'kxlkjuleIt
call|призыв, вызов, визит, звать|kO:l
camera|камера|'kxmqrq
camp|лагерь|kxmp
campaign|компания, проводить кампанию|kxm'peIn
can|мочь|kxn
canal|канал|kq'nxl
candidate|кандидат|'kxndIdIt
capable|способный|'keIpqbl
capacity|способность|kq'pxsItI
capital|столица, капитал, прописной|'kxpItl
capitalist|капиталист|'kxpItqlIst
captain|капитан|'kxptIn
capture|захватить, поимка, взятие в плен|'kxptSq
car|автомобиль, вагон|kQ:
care|забота,  обслуживание, заботиться|kFq
career|карьера, деятельность|kq'rIq
carefully|осторожно, внимательно|'kFqflI
carnival|карнавал|'kQ:nIvql
carrier|носильщик, транспортное средство|'kxrIq
carry|нести, носить, переносить|'kxrI
case|случай, доводы, судебное дело|keIs
cast|метание, количество, состав исполнителей|kQ:st
castle|замок, ладья|'kQ:sl
catch|схватить, ловить, понять, догнать|kxtS
cause|быть причиной, вызывать, повод|kO:z
cease|прекращать, останавливать|si:s
cease-fire|прекращение огня|'si:s,faIq
ceiling|потолок, максимум, предел|'si:lIN
celebrate|праздновать, прославлять|'selIbreIt
celebration|празднование, прославление|,selI'breISqn
cell|камера, ячейка|sel
cement|цемент, основа|sI'ment
cent|цент|sent
central|центральный, основной|'sentrql
centre|центр, концентрировать|'sentq
century|столетие, век|'sentSurI
ceremony|церемония, церемониал|'serImqnI
certain|определенный, некоторый, некий|'sq:tn
certainly|конечно, непременно|'sq:tnlI
chain|цепь, последовательность|tSeIn
chairman|председатель|'tSFqmqn
challenge|вызов, бросать вызов, сомневаться|'tSxlIndZ
chamber|палата, зал|'tSeImbq
champion|чемпион, защитник|'tSxmpjqn
championship|чемпионат|'tSxmpjqnSIp
chance|случай, шанс, риск|tSQ:ns
chancellor|канцлер|'tSQ:nsqlq
change|перемена, изменение, менять|tSeIndZ
chapel|часовня, капелла|'tSxp(q)l
character|характер, качество, признак|'kxrIktq
charge|нагрузка, забота, обязанности, поручать|tSQ:dZ
charter|хартия, устав|'tSQ:tq
cheap|дешевый|tSi:p
check|чек, проверка, шах|tSek
cheese|сыр|tSi:z
chemical|химический|'kemIkql
chief|начальник,главный, основной|tSi:f
child|ребенок, младенец|tSaIld
chorus|хор|'kO:rqs
cigar|сигара|sI'gQ:
circle|круг, кружок, область, двигаться по кругу|'sq:kl
circuit|кругооборот, окружность|'sq:kIt
circulate|циркулировать, распространяться|'sq:kjuleIt
circumstances|обстоятельства, условия|
citizen|гражданин|'sItIzn
citizenship|гражданство|'sItIznSIp
city|город|'sItI
civil|гражданский, вежливый|'sIvl
civilian|гражданское лицо|sI'vIljqn
claim|требование, претензия, заявлять|kleIm
clear|ясный, понятный, ясно, оправдывать|klIq
clearly|ясно, отчетливо, несомненно|'klIqlI
clergy|духовенство|'klq:dZI
clerk|клерк|klQ:k
close|близко, почти, закрывать, тайный|klqus
closely|близко, тесно, внимательно|'klquslI
closure|закрытие|'klquZq
cloth|ткань, одежда|klOT
clothing|одежда|'klquDIN
club|клуб, дубинка|klAb
co-operation|сотрудничество, кооперация|kqu,Opq'reISqn
co-operative|совместный, сотрудничающий, кооперативный|kqu'OpqrqtIv
coach|туристический автобус, тренер|kqutS
coal|уголь|kqul
coalition|коалиция|,kquq'lISqn
coast|берег, побережье|kqust
coat|пиджак, пальто|kqut
code|кодекс, свод законов|kqud
coffee|кофе|'kOfI
cold|холодный|kquld
colleague|коллега|'kOli:g
collect|собирать|kq'lekt
collection|собрание, скопление|kq'lekSqn
college|колледж, коллегия|'kOlIdZ
collision|столкновения|kq'lIZqn
colonial|колониальный|kq'lqunjql
colour|цвет, оттенок|'kAlq
coloured|цветной|'kAlqd
column|колонна, колонка|'kOlqm
combat|бой, борьба|'kOmbqt
combination|комбинация, объединение|,kOmbI'neISqn
come|приходить, прибывать, достигать|kAm
comfort|комфорт, уют, утешение, покой|'kAmfqt
command|приказ, командовать|kq'mQ:nd
commander|командир, командующий|kq'mQ:ndq
comment|комментарий,комментировать|'kOment
commission|комиссия, комитет|kq'mISqn
commissioner|представитель, уполномоченный|kq'mISnq
commitment|обязательство, вручение, арест|kq'mItmqnt
committee|комитет, комиссия|,kOmI'ti:
common|общий, общественный, обычный|'kOmqn
communication|сообщение, связь, общение|kq,mju:nI'keISqn
communique|официальное сообщение|kq'mju:nIkeI
community|община, общество, объединение|kq'mju:nItI
company|компания|'kAmpqnI
compare|сравнивать|kqm'pFq
comparison|сравнение|kqm'pxrIsn
compel|заставлять, принуждать|kqm'pel
compensation|компенсация|,kOmpen'seISqn
competition|соревнование, конкуренция|,kOmpI'tISqn
competitive|конкурирующий, конкурентоспособный|kqm'petItIv
complain|жаловаться|kqm'pleIn
complaint|жалоба, недовольство|kqm'pleInt
complete|заканчивать, завершать, полный|kqm'pli:t
completely|совершенно, полностью|kqm'pli:tlI
component|компонент|kqm'pqunqnt
composer|композитор|kqm'pquzq
comprehensive|обширный, понятливый, всесторонний|,kOmprI'hensIv
concentrate|концентрировать|'kOnsqntreIt
concentration|концентрация, сосредоточенность|,kOnsqn'treISqn
concept|концепция, понятие, идея|'kOnsept
concern|касаться, отношение, беспокоить|kqn'sq:n
concert|концерт|'kOnsq(:)t
conciliation|примирение, умиротворение|kqn,sIlI'eISqn
conclude|завершать, заключать|kqn'klu:d
conclusion|завершение, заключение, результат|kqn'klu:Zqn
condemn|осуждать, приговаривать|kqn'dem
condition|условие|kqn'dISqn
conduct|вести, руководитель, проводить|'kOndAkt
conductor|кондуктор, проводник, дирижер|kqn'dAktq
confederation|конфедерация|kqn,fedq'reISqn
conference|конференция|'kOnfqrqns
confession|признание, исповедь|kqn'feSqn
confidence|доверие, секрет, уверенность|'kOnfIdqns
confident|уверенный|'kOnfIdqnt
confidential|конфиденциальный, доверчивый|,kOnfI'denSql
confrontation|конфронтация|,kOnfrAn'teISqn
confusion|смущение, замешательство, беспорядок|kqn'fju:Zqn
congress|конгресс, съезд|'kONgres
connect|соединять, связывать|kq'nekt
connection|связь|kq'nekSqn
consequence|следствие, вывод, значение|'kOnsIkwqns
conservative|консерватор, реакционер, консервативный|kqn'sq:vqtIv
consider|рассматривать, обсуждать, обдумывать|kqn'sIdq
considerable|значительный, важный|kqn'sIdqrqbl
considerably|значительно|kqn'sIdqrqblI
consideration|рассмотрение, соображение|kqn,sIdq'reISqn
consist|состоять, заключаться|kqn'sIst
consolidate|укреплять, объединять|kqn'sOlIdeIt
conspiracy|заговор, конспирация|kqn'spIrqsI
constantly|постоянно|'kOnstqntlI
constituency|избиратели, избирательный округ|kqn'stItjuqnsI
constitution|конституция|,kOnstI'tju:Sqn
constitutional|конституционный|,kOnstI'tju:Sqnl
construction|строительство, конструкция|kqn'strAkSqn
consult|советоваться, справляться|kqn'sAlt
consultant|консультант|kqn'sAltqnt
consultation|консультация|,kOnsql'teISqn
consumer|потребитель, абонент|kqn'sju:mq
consumption|потребление, расход|kqn'sAmpSn
contact|быть в контакте,  контакт, связь|kqn'txkt
contain|содержать, сдерживать|kqn'teIn
content|содержимое, суть, удовлетворение|'kOntent
context|контекст, ситуация|'kOntekst
continental|континентальный|,kOntI'nentl
continue|продолжать, простираться|kqn'tInju(:)
contrary|противоположный|kqn'trFqrI
contrast|контраст|'kOntrQ:st
contribute|делать вклад, способствовать|kqn'trIbju(:)t
contribution|взнос, вклад, сотрудничество|,kOntrI'bju:Sqn
control|контроль, управление, регулировать|kqn'trqul
controversial|спорный, полемический|,kOntrq'vq:Sql
controversy|дискуссия, спор|'kOntrqvq:sI
convener|член, который назначает день собрания|kqn'vi:nq
convention|собрание, съезд|kqn'venSqn
conventional|обычный, обусловленный|kqn'venSqnl
conversation|беседа, неофициальные переговоры|,kOnvq'seISqn
conversion|превращение, обращение|kqn'vq:Sqn
convert|превращать, обращать, конвертировать|'kOnvq:t
convey|перевозить, передавать, сообщать|kqn'veI
convict|признать виновным, осудить|'kOnvIkt
conviction|осуждение, убеждение, убежденность|kqn'vIkSqn
convince|убеждать|kqn'vIns
copy|экземпляр, копия|'kOpI
corner|угол, уголок|'kO:nq
corporation|корпорация|,kO:pq'reISqn
correct|правильный, точный, подходящий|kq'rekt
correspondent|корреспондент|,kOrIs'pOndqnt
cost|цена, стоимость, стоить|kOst
cottage|коттедж|'kOtIdZ
council|совет, муниципалитет, совещание|'kaunsl
councillor|советник, член муниципалитета|
counsel|обсуждение, совет, решение, адвокат|'kaunsl
count|считать, подсчитывать, учитывать, полагать|kaunt
country|страна, местность, сельская местность|'kAntrI
county|графство|'kauntI
coup|удар, государственный переворот|ku:
couple|соединять, связывать, пара|'kApl
course|курс, ход|kO:s
court|суд, судьи, двор, добиваться|kO:t
cover|покрышка, переплет, закрывать|'kAvq
craft|ремесло, искусство, судно|krQ:ft
crash|потерпеть крах, потерпеть крушение|krxS
create|создавать, творить|krI(:)'eIt
creation|создание|krI(:)'eISqn
credit|вера, доверие, репутация|'kredIt
crew|экипаж, команда, бригада|kru:
crime|преступление|kraIm
crisis|кризис|'kraIsIs
critical|критический|'krItIkql
criticism|критика|'krItIsIzm
criticize|критиковать|'krItIsaIz
crop|урожай|krOp
cross|пересекать, скрещивать, противодействовать|krOs
crown|корона, венец, крона|kraun
cultural|культурный|'kAltSqrql
culture|культура|'kAltSq
cup|чашка, кубок|kAp
curb|узда, обуздание, сдерживать|kq:b
currency|валюта|'kArqnsI
current|текущий, современный|'kArqnt
currently|общепринятым образом|
customer|потребитель|'kAstqmq
cut|порез, резать, сокращение|kAt
daily|ежедневная газета, ежедневный|'deIlI
dam|дамба, плотина|dxm
damage|вред, повреждать, убыток|'dxmIdZ
danger|опасность, угроза, риск|'deIndZq
dangerous|опасный, угрожающий|'deIndZrqs
date|дата, число, день, время, датировать|deIt
daughter|дочь|'dO:tq
day|день, сутки|deI
dead|мертвый, погибший|ded
deal|вести дела, рассматривать, иметь дело|di:l
dealer|торговец, биржевик|'di:lq
dealing|раздача|'di:lIN
dean|декан, ректор|di:n
death|смерть, гибель|deT
debate|дебаты, спор, полемика|dI'beIt
debt|долг|det
decade|десяток, десятилетие|'dekeId
decide|решать|dI'saId
decided|определенный, решительный|dI'saIdId
decision|решение, решимость|dI'sIZqn
declare|заявлять, объявлять, декларация|dI'klFq
decline|опускаться, уменьшаться, убывать|dI'klaIn
deep|глубокий, глубиной в|di:p
deeply|глубоко, низко, сильно|'di:plI
defeat|поражение, крушение, наносить поражение|dI'fi:t
defence|защита, оборона|dI'fens
defend|защищать, оборонять|dI'fend
defendant|ответчик, обвиняемый|dI'fendqnt
defiance|неповиновение, пренебрежение|dI'faIqns
deficit|дефицит|'defIsIt
degree|ступень, степень, ранг, звание|dI'gri:
delay|отсрочка, задерживать, откладывать, медлить|dI'leI
delegate|делегат, депутат|'delIgeIt
delegation|делегация, поручение|,delI'geISqn
deliver|передавать, доставлять, посылать|dI'lIvq
delivery|доставка, поставка, подача|dI'lIvqrI
demand|требование, потребность, спрос, требовать, нуждаться|dI'mQ:nd
democracy|демократия|dI'mOkrqsI
democrat|демократ|'demqkrxt
democratic|демократический|,demq'krxtIk
demonstrate|демонстрировать, показывать|'demqnstreIt
demonstration|демонстрация|,demqns'treISqn
demonstrator|демонстратор, демонстрант|'demqnstreItq
denounce|осуждать, разоблачать|dI'nauns
deny|отрицать, отвергать|dI'naI
department|отдел, цех, магазин|dI'pQ:tmqnt
depend|зависеть|dI'pend
deputy|представитель, депутат, заместитель|'depjutI
describe|описывать|dIs'kraIb
design|замысел, план, цель, планировать, предназначать|dI'zaIn
desk|стол, редакция газеты|desk
despite|несмотря на|dIs'paIt
destroy|разрушать, уничтожать|dIs'trOI
detail|деталь, подробность|'di:teIl
detailed|детальный, подробный|'di:teIld
determination|решимость, определение|dI,tq:mI'neISqn
determine|определять, устанавливать, разрешать|dI'tq:mIn
develop|развивать, показывать, обнаруживать|dI'velqp
development|развитие, изложение, результат|dI'velqpmqnt
device|схема, проект, прием, устройство|dI'vaIs
devote|посвящать|dI'vqut
diamond|алмаз, бриллиант|'daIqmqnd
die|умирать, исчезать, отмирать|daI
difference|разница, различие|'dIfrqns
different|различный, иной, другой|'dIfrqnt
difficult|трудный|'dIfIkqlt
difficulty|трудность, затруднение|'dIfIkqltI
dinner|обед|'dInq
diplomatic|дипломатический, дипломатичный|,dIplq'mxtIk
direct|прямо, направлять, руководитель, учить|dI'rekt
direction|направление, руководство, указание|dI'rekSqn
directly|прямо, непосредственно, сразу|dI'rektlI
director|член правления, директор, руководитель|dI'rektq
disappear|исчезать, пропадать|,dIsq'pIq
disappointment|разочарование, причина разочарования|,dIsq'pOIntmqnt
disarmament|разоружение|dIs'Q:mqmqnt
disaster|бедствие, несчастье|dI'zQ:stq
discipline|дисциплина, обучение|'dIsIplIn
disclose|раскрывать, открывать, разоблачать|dIs'klquz
discover|открывать|dIs'kAvq
discrimination|дискриминация, различение|dIs,krImI'neISqn
discuss|обсуждать|dIs'kAs
discussion|обсуждение, дискуссия, дебаты|dIs'kASqn
dismiss|отпускать, распускать, увольнять|dIs'mIs
dismissal|роспуск, увольнение|dIs'mIsql
disorder|беспорядок|dIs'O:dq
disposal|вручение, право распоряжаться|dIs'pquzql
dispute|диспут, полемика, обсуждать|dIs'pju:t
distance|дистанция, расстояние, сдержанность|'dIstqns
distant|отдаленный, дальний|'dIstqnt
distinguish|отличать, различать, разделять|dIs'tINgwIS
distribute|распределять, распространять|dIs'trIbju(:)t
distribution|распределение, распространение|,dIstrI'bju:Sqn
district|округ, район, участок|'dIstrIkt
disturb|нарушать, беспокоить, срывать|dIs'tq:b
divide|делить, подразделять, распределять|dI'vaId
dividend|дивиденд|'dIvIdend
division|деление, распределение, округ|dI'vIZqn
do|делать, годиться, заниматься|du:
doctor|доктор, врач|'dOktq
doctor (Dr.)|доктор|
document|документ|'dOkjument
dog|собака|dOg
dollar|доллар|'dOlq
domestic|домашний, внутренний|dq'mestIk
dominate|господствовать, сдерживать|'dOmIneIt
don|дон|dOn
door|дверь, дверца|dO:
doubt|сомнение, сомневаться|daut
down|вниз, идущий на убыль, ниже|daun
dozen|дюжина|'dAzn
draft|чертеж, проект|drQ:ft
drama|драма|'drQ:mq
draw|тащить, приближать|drO:
drawing|протаскивание, вытягивание, рисование, чертеж|'drO:IN
dress|платье, одежда, одевать|dres
drift|сносить, плыть по течению|drIft
drive|управлять, ездить|draIv
driver|водитель|'draIvq
drop|капля, падать, снижаться, ронять|drOp
drug|лекарство, наркотик|drAg
due|должный, обязанный, точно|dju:
during|во время, в течение|'djuqrIN
dust|пыль, пылинка, прах|dAst
duty|долг, обязанность, дежурство|'dZu:tI
each|каждый, любой|i:tS
early|ранний, своевременный, рано|'q:lI
earn|зарабатывать, заслуживать|q:n
earnings|заработок|'q:nINz
earth|земля|q:T
ease|свобода, легкость, облегчать|i:z
easily|легко, охотно|'i:zIlI
east|восточный, восток|i:st
eastern|восточный|'i:stqn
easy|легкий, удобный, спокойный|'i:zI
eat|есть, иметь вкус|i:t
economic|экономный, практический|,i:kq'nOmIk
economics|экономика|,i:kq'nOmIks
economy|экономика, экономия|I(:)'kOnqmI
editor|редактор, издатель|'edItq
editorial|редакционная статья|,edI'tO:rIql
education|образование, просвещение, обучение|,edju(:)'keISqn
educational|образовательный, воспитательный|,edju(:)'keISqnl
effect|результат, осуществлять, оформлять|I'fekt
effective|эффективный, действующий|I'fektIv
effort|усилие, попытка, произведение|'efqt
egg|яйцо|eg
eight|восемь, восьмерка|eIt
eighteen|восемнадцать|,eI'ti:n
either|любой|'aIDq
either...or|или...или,  либо...либо|
elect|выбирать|I'lekt
election|выборы, выбор|I'lekSqn
electric|электрический|I'lektrIk
electrical|электрический|I'lektrIkql
electricity|электричество|Ilek'trIsItI
element|элемент|'elImqnt
eleven|одиннадцать|I'levn
eliminate|исключать, уничтожать, ликвидировать|I'lImIneIt
else|еще, кроме|els
elsewhere|где-нибудь в другом месте|'els'wFq
embassy|посольство|'embqsI
emerge|появляться, выясняться, возникать|I'mq:dZ
emergency|непредвиденный случай|I'mq:dZqnsI
emphasis|подчеркивание, ударение, выразительность|'emfqsIs
emphasize|подчеркивать|'emfqsaIz
empire|империя, господство|'empaIrq
employ|нанимать, использовать, служба|Im'plOI
employee|служащий|,emplOI'i:
employer|наниматель|Im'plOIq
employment|работа, занятость, наем|Im'plOImqnt
empty|пустой|'emptI
enable|давать возможность, делать возможным|I'neIbl
encounter|встретить, сталкиваться|In'kauntq
encourage|ободрять, поощрять, подстрекать|In'kArIdZ
end|конец, окончание, цель, результат|end
ended|оконченный, законченный|
ending|окончание, завершение|'endIN
enemy|противник, враг|'enImI
energy|энергия|'enqdZI
enforce|принуждать, навязывать, проводить в жизнь|In'fO:s
engage|нанимать, занимать, обязывать|In'geIdZ
engine|машина, двигатель, локомотив|'endZIn
engineer|инженер, механик, машинист|,endZI'nIq
engineering|техника, машиностроение, махинации|,endZI'nIqrIN
enlarge|увеличивать, расширять, распространяться|In'lQ:dZ
enormous|громадный, ужасный|I'nO:mqs
enough|достаточно, до некоторой степени, достаточный|I'nAf
ensure|обеспечивать, гарантировать|In'Suq
enter|входить, вступать, вписывать|'entq
enterprise|предприятие, предприимчивость|'entqpraIz
entertain|принимать во внимание, развлекать|,entq'teIn
entertainment|зрелище, развлечение|,entq'teInmqnt
enthusiasm|энтузиазм|In'Tju:zIxzm
entire|полный, целый, сплошной|In'taIq
entirely|совершенно, полностью, исключительно|In'taIqlI
entitle|давать право, титуловать|In'taItl
entry|вход, вступление, поступление|'entrI
environment|окружение, окружающая среда|In'vaIqrqnmqnt
equal|равный, одинаковый, соответствующий|'i:kwql
equality|равенство, равноправие|I(:)'kwOlItI
equally|поровну, одинаково, в равной степени|'i:kwqlI
equip|оборудовать, снабжать, обеспечивать|I'kwIp
equipment|оборудование, оснащение, снаряжение|I'kwIpmqnt
equity|беспристрастность, справедливость|'ekwItI
escape|бегство, побег, спасение, бежать|Is'keIp
especially|особенно, в особенности, главным образом|Is'peSqlI
essential|обязательный, существенный, важный|I'senSql
establish|учреждать, создавать, утверждать|Is'txblIS
establishment|установление, учреждение, положение|Is'txblISmqnt
estate|поместье, имущество, сословие|Is'teIt
estimate|оценка, проект, оценивать|'estImeIt
even|даже, как раз, ровный, четный|'i:vqn
evening|вечер|'i:vnIN
event|событие, случай, исход, результат|I'vent
eventually|в конечном счете, в конце концов|I'ventSqlI
ever|либо, когда бы то ни было|'evq
every|каждый, всякий|'evrI
everybody|каждый, всякий, все|'evrIbOdI
everyone|все, каждый, всякий|'evrIwAn
everything|все|'evrITIN
everywhere|везде, повсюду|'evrIwFq
evidence|свидетельство, показание|'evIdqns
exactly|точно, как раз, именно|Ig'zxktlI
examination|осмотр, обследование, экзамен, проверка|Ig,zxmI'neISqn
examine|рассматривать, осматривать|Ig'zxmIn
example|пример, экземпляр|Ig'zQ:mpl
exceed|превышать, превосходить|Ik'si:d
excellent|превосходный, отличный|'eksqlqnt
exception|исключение, возражение, оговорка|Ik'sepSqn
exchange|обмен, замена, менять, обменивать|Iks'tSeIndZ
excite|возбуждать, вызывать|Ik'saIt
excited|возбужденный|
exclude|исключать|Iks'klu:d
exclusive|исключительный, недоступный|Iks'klu:sIv
executive|исполнительная власть, правительственный|Ig'zekjutIv
exercise|упражнение, осуществление, упражнять|'eksqsaIz
exhibition|выставка, показ, проявление|,eksI'bISqn
exist|быть, существовать, иметься|Ig'zIst
existence|существование|Ig'zIstqns
expand|расширять, распространять|Iks'pxnd
expansion|расширение, распространение|Iks'pxnSqn
expect|ожидать, ждать, полагать|Iks'pekt
expected|предполагаемый, ожидаемый|
expel|изгонять, исключать|Iks'pel
expenditure|расход, статья расходов|Iks'pendItSq
expense|расход, счет, цена|Iks'pens
expensive|дорогой|Iks'pensIv
experience|опыт, опытность|Iks'pIqrIqns
experienced|опытный|Iks'pIqrIqnst
experiment|эксперимент|Iks'perIment
expert|опытный, квалифицированный, специалист|'ekspq:t
explain|объяснять|Iks'pleIn
explanation|объяснение|,eksplq'neISqn
explode|взрывать, подрывать|Iks'plqud
explosion|взрыв, вспышка|Iks'plquZqn
export|экспорт, экспортировать|'ekspO:t
expose|выставлять, подвергать, разоблачать|eks'pquzeI
express|выражать, отражать|Iks'pres
extend|простирать, расширять, увеличивать|Iks'tend
extension|протяженность, расширение, продление|Iks'tenSqn
extent|степень, размер, величина|Iks'tent
extra|дополнительный, особый, дополнительно|'ekstrq-
extraordinary|необычайный, чрезвычайный|Iks'trO:dnrI
extreme|крайний, чрезвычайный|Iks'tri:m
eye|глаз, разглядывать, держать под наблюдением|aI
eye witness|свидетель|
face|лицо, поверхность, грань, быть обращенным к|feIs
facility|легкость, способность, умение|fq'sIlItI
fact|факт, истина, действительность|fxkt
factor|фактор|'fxktq
factory|фабрика, завод|'fxktqrI
faculty|способность, власть, факультет|'fxkqltI
failure|неудача, провал, недостаток|'feIljq
fair|ярмарка, выставка, честный, справедливый|fFq
fairly|честно, справедливо, довольно|'fFqlI
faith|вера, верность, обещание|feIT
fall|падать, пасть, погибнуть, выпадать, попадать|fO:l
false|ложный, фальшивый|fO:ls
familiar|близкий, знакомый|fq'mIljq
famous|знаменитый|'feImqs
fan|веер, фен, болельщик|fxn
far|далеко, давно, гораздо, намного, дальний|fQ:
farmer|фермер|'fQ:mq
fashion|образ, манера, фасон, стиль|'fxSqn
fashionable|модный, фешенебельный|'fxSnqbl
fat|жирный, обильный|fxt
father|отец|'fQ:Dq
fault|недостаток, вина, ошибка|fO:lt
favour|расположение, предпочтение, поддерживать|'feIvq
favourable|благоприятный|'feIvqrqbl
fear|страх, опасение, бояться, опасаться|fIq
feature|черта, признак, особенность|'fi:tSq
federal|федеральный|'fedqrql
federation|федерация|,fedq'reISqn
feed|кормить, питать|fi:d
feel|чувствовать, испытывать, воспринимать|fi:l
feeling|чувство|'fi:lIN
fellow|товарищ, собрат, аспирант|'felqu
festival|праздник, фестиваль|'festqvl
few|немного, мало, незначительное количество|fju:
field|поле, участок, область, ставить ставку|fi:ld
fifth|пятый|fIfT
fifty|пятьдесят|'fIftI
fight|бой, борьба, бороться, сражаться|faIt
fighting|бой, сражение|'faItIN
figure|изображать, представлять себе, цифра, фигура|'fIgq
file|подшивка, досье, картотека|faIl
fill|наполнять, заполнять, занимать|fIl
film|пленка, фильм, кино, снимать фильм|fIlm
filming|киносъемка|
final|финал,  последний|'faInl
finally|в конце концов, окончательно|'faInqlI
finance|финансы, финансировать|faI'nxns
financial|финансовый|faI'nxnSql
find|находить, обнаруживать|faInd
finding|находка, открытие, решение|'faIndIN
fine|ясный, погожий, прекрасный, очищать|faIn
finger|палец|'fINgq
finish|конец, завершенность, завершать, доводить до конца|'fInIS
fire|огонь, пожар, жар, пыл, зажигать, взрывать, воспламенять|'faIq
firm|твердый, крепкий, решительный, фирма|fq:m
firmly|твердо, решительно|
first|первый|fq:st
fiscal|сборщик налогов, судебный исполнитель, финансовый|'fIskql
fish|рыба|fIS
fit|соответствовать, годиться, подгонять, пригодный|fIt
five|пять, пятерка|faIv
fix|устанавливать, фиксировать|fIks
fixture|что-либо твердо установленное, заранее назначенный день|'fIksttSq
flag|флаг, флагман|flxg
flame|пламя, сияние, пыл|fleIm
flat|плоский, ровный, мелкий|flxt
fleet|флот|fli:t
flight|полет, рейс, перелет|flaIt
floor|пол, этаж, аудитория|flO:
flow|течь, происходить|flqu
flower|цветок, цветение|'flauq
fly|летать, развеваться, спасаться бегством|flaI
follow|следовать, следить|'fOlqu
following|следующий|'fOlquIN
food|пища, еда, продовольствие|fu:d
foot|идти пешком, подсчитывать, нога, ступня, шаг, основание|fut
football|футбол|'futbO:l
for|в течение, в, к, для, за, на, вместо, потому что|fO:
force|вынуждать, брать силой, заставлять|fO:s
forced|принудительный, принужденный|fO:st
forecast|предсказание, прогноз|'fO:kQ:st
foreign|иностранный, чужой, чуждый|'fOrIn
forest|лес|'fOrIst
forget|забывать, упустить из виду|fq'get
form|форма, вид, стиль, класс, придавать форму|fO:m
formal|официальный, формальный|'fO:mql
formation|образование, структура, формирование|fO:'meISqn
formed|сформировавшийся, организованный|
former|бывший, первый|'fO:mq
formerly|прежде, некогда|
forth|вперед, дальше, впредь|fO:T
fortnight|две недели, четырнадцать дней|'fO:tnaIt
forty|сорок|'fO:tI
forum|форум|'fO:rqm
forward|вперед, дальше, впредь, далее, нападающий|'fO:wqd
foundation|основание, основа, фонд|faun'deISqn
four|четыре, четверка|fO:
frame|каркас, конструкция, структура|freIm
frank|искренний, откровенный, открытый|frxNk
free|бесплатно, освобождать|fri:
freedom|свобода, освобождение|'fri:dqm
freeze|замерзать, замораживать, замораживание|fri:z
frequently|часто, постоянно|
fresh|свежий, новый, бодрый|freS
friend|друг, товарищ, сторонник|frend
friendship|дружба|'frendSIp
fringe|бахрома, край|frIndZ
from|из, с|frOm
front|передний план, передний|frAnt
fuel|топливо, горючее|fjuql
full|полный, наполненный, прямо, точно|ful
fully|полностью, совершенно|'fulI
function|функция, торжество|'fAnNkSqn
fund|фонд|fAnd
fundamental|основной, существенный|,fAndq'mentl
funny|забавный|'fAnI
fur|мех|fq:
furlong|восьмая часть мили (= 201м)|'fq:lON
further|более отдаленный|'fq:Dq
future|будущее, будущий|'fju:tSq
gain|выигрыш, получать|geIn
gallery|галерея|'gxlqrI
game|игра|geIm
gang|бригада|gxN
gap|брешь|gxp
garden|сад, огород|'gQ:dn
gardener|садовник|'gQ:dnq
gas|газ|gxs
gate|ворота|geIt
gather|собирать|'gxDq
gene|ген|dZi:n
general|генерал, общий|'dZenqrql
generally|обычно|'dZenqrqlI
generation|поколение|,dZenq'reISqn
gentleman|джентльмен|'dZentlmqn
get|доставать, получать|get
girl|девочка|gq:l
give|давать|gIv
given|данный|'gIvn
glass|стекло|glQ:s
go|идти|gquz
go fishing|ловить рыбу|
goal|цель|gqul
god|бог|gOd
going|работающий, действующий, существующий|'gquIN
good|добро, хороший|gud
govern|управлять|'gAvqn
government|правительство|'gAvnmqnt
governor|губернатор|'gAvqnq
graduate|окончивший ВУЗ|'grxdjueIt
grain|зерно, раздроблять|greIn
grand|величественный|grxnd
grant|дар, даровать|grQ:nt
grass|трава|grQ:s
grave|серьезный, важный|greIv
great|большой, великий|greIt
greatly|очень, весьма|'greItlI
green|зеленый, листва, растительность|gri:n
grey|серый|greI
gross|большой|grqus
ground|земля, местность|graund
grow|расти|grqu
growth|развитие|grquT
guest|гость|gest
guidance|руководство|'gaIdqns
guideline|директива|
guilty|виновный|'gIltI
hair|волос|hFq
half|наполовину|hQ:f
hall|зал|hO:l
ham|окорок, ветчина|hxm
hand|рука, вручать|hxnd
handicap|скачки|'hxndIkxp
handle|регулировать|'hxndl
handling|обращение|'hxndlIN
hang|привязывать, вешать, висеть|hxN
happen|случаться|'hxpqn
happy|счастливый|'hxpI
hard|сильно, твердый|hQ:d
hardly|еле, едва|'hQ:dlI
hat|шапка|hxt
hatred|ненависть|'heItrId
have|быть должным, иметь|hxv
hay|сено|heI
head|голова, возглавлять|hed
headline|заголовок|'hedlaIn
headquarters|квартира|'hed'kwO:tqz
health|здоровье|helT
hear|слушать|hIq
hearing|слух|'hIqrIN
heart|сердце, душа|hQ:t
heat|жара, зной, нагревать|hi:t
heavily|тяжело|'hevIlI
heavy|крупный, тяжелый|'hevI
height|высота|haIt
helicopter|вертолет|'helIkOptq
help|помощь, помогать|help
her|ее, свой|hq:
here|здесь, тут|hIq
hero|герой|'hIqrqu
herself|себя|hq:'self
hide|прятать|haId
high|высокий, высоко, максимум|haI
highly|сильно|'haIlI
hill|холм|hIl
himself|собой|hIm'self
his|его, свой|hIz
historic|исторический|hIs'tOrIk
history|история|'hIstqrI
hold|власть, влияние, удерживать|hquld
holder|обладатель|'hquldq
holding|держащий|'hquldIN
hole|яма|hqul
holiday|праздник|'hOlqdI
honour|честь, почитать|'Onq
hope|надежда, надеяться|hqup
horse|конь|hO:s
hospital|госпиталь, больница|'hOspItl
hostility|враждебность|hOs'tIlItI
hotel|гостиница|hqu'tel
hour|час|'auq
house|здание|haus
housing|дом|'hauzIN
how|каким образом, как|hau
however|как бы ни, тем не менее|hau'evq
huge|огромный|hju:dZ
human|человеческий|'hju:mqn
hundred|сто|'hAndrqd
hunt|охота, охотиться|hAnt
husband|супруг|'hAzbqnd
ice|лед|aIs
idea|идея|aI'dIq
ideological|идеологический|,aIdIq'lOdZIkql
if|если|If
ignore|игнорировать|Ig'nO:
illegal|нелегальный|I'li:gql
illness|болезнь|'IlnIs
image|изображение, образ, имидж|'ImIdZ
imagine|предполагать|I'mxdZIn
immediate|непосредственный|I'mi:djqt
immediately|немедленно|I'mi:djqtlI
immigrant|иммигрант|'ImIgrqnt
immigration|иммиграция|,ImI'greISqn
impact|удар|'Impxkt
implement|выполнять|'ImplIment
imply|подразумевать|Im'plaI
importance|значение|Im'pO:tqns
important|значительный|Im'pO:tqnt
impose|налагать|Im'pquz
impossible|невозможный|Im'pOsqbl
impressive|впечатляющий|Im'presIv
improve|совершенствовать|Im'pru:v
improvement|улучшение|Im'pru:vmqnt
in|в, на, внутри|In
inadequate|неадекватный|In'xdIkwIt
inch|дюйм|IntS
incident|инцидент|'InsIdqnt
include|содержать|In'klu:d
including|включая|In'klu:dIN
income|доход|'InkAm
increase|рост|'Inkri:s
increasing|возрастающий|
increasingly|все больше и больше|In'kri:sINlI
indeed|действительно|In'di:d
independence|независимость|,IndI'pendqns
independent|независимый|,IndI'pendqnt
index|индекс, указатель, показатель|'Indeks
indicate|указывать|'IndIkeIt
indication|признак, указание, знак|,IndI'keISqn
indictment|обвинительный акт|In'daItmqnt
individual|личность, индивидуальный|,IndI'vIdjuql
industrial|индустриальный|In'dAstrIql
industry|промышленность|'IndqstrI
inevitable|неизбежный|In'evItqbl
inflation|инфляция|In'fleISqn
inform|сообщать|In'fO:m
information|информация|,Infq'meISqn
initial|начальный|I'nISql
initiate|начинать|I'nISIeIt
initiative|инициатива|I'nISIqtIv
inject|впрыскивать|In'dZekt
injunction|предписание|In'dZANkSqn
injure|ушибиться|'IndZq
injury|телесное повреждение|'IndZqrI
innings|подача (в игре с мячом)|'InINz
inquiry|расследование|In'kwaIqrI
insist|настаивать|In'sIst
inspector|инспектор|In'spektq
instance|пример|'Instqns
instead|взамен, вместо|In'sted
institute|институт|'InstItju:t
institution|учреждение|,InstI'tju:Sqn
instruct|инструктировать|In'strAkt
instrument|инструмент|'Instrumqnt
insurance|страхование, страховка|In'Suqrqns
integration|объединение|,IntI'greISqn
intelligence|интеллект|In'telIdZqns
intend|намереваться|In'tend
intensive|интенсивный|In'tensIv
intent|цель|In'tent
intention|намерение|In'tenSqn
interest|интерес, интересовать|'IntrIst
interested|заинтересованный|'IntrIstId
interesting|интересный|'IntrIstIN
internal|внутренний|In'tq:nl
international|интернациональный|,Intq(:)'nxSqnl
intervention|посредничество|,Intq(:)'venSqn
into|к, до, в|'Intu
introduce|вводить|,Intrq'dju:s
introduction|введение, вступление|,Intrq'dAkSqn
invest|помещать капитал|In'vest
investigate|исследовать|In'vestIgeIt
investigation|следствие|In,vestI'geISqn
investment|капиталовложение|In'vestmqnt
investor|вкладчик|In'vestq
invitation|по приглашению|,InvI'teISqn
invite|приглашать|In'vaIt
involve|включать в себя|In'vOlv
involvement|вмешательство|In'vOlvmqnt
island|остров|'aIlqnd
isolate|изолировать|'aIsqleIt
issue|издание, издавать|'ISu:
it|оно|It
item|статья|'aItqm
its|его, ее|Its
itself|себя, себе|It'self
jacket|куртка|'dZxkIt
jail|тюремное заключение, заключать в тюрьму|dZeIl
jet|реактивный двигатель|dZet
job|работа, дело|dZqub
jockey|жокей|'dZOkI
join|соединять|dZOIn
joint|объединенный, соединение|dZOInt
journal|журнал|'dZq:nl
journalist|журналист|'dZq:nqlIst
judge|судья, судить|'dZAdZ
judgement|приговор|'dZAdZmqnt
junior|младший|'dZu:njq
jury|присяжные заседатели|'dZuqrI
just|именно, как раз, справедливый|dZAst
justice|справедливость|'dZAstIs
justify|оправдывать|'dZAstIfaI
keen|острый|ki:n
keep|держать|ki:p
kill|убивать|kIl
kind|сорт,  доброжелательный|kaInd
king|король|kIN
knock|стучать|nOk
know|знать|nqu
knowledge|знание|'nOlIdZ
laboratory|лаборатория|lq'bOrqtqrI
lack|недостаток, нуждаться|lxk
lady|леди|'leIdI
lake|озеро|leIk
land|земля|lxnd
lane|дорожка|leIn
language|язык|'lxNgwIdZ
large|многочисленный|lQ:dZ
largely|обильно|'lQ:dZlI
last|длиться, прошлый, в последний раз|lQ:st
late|поздно, опоздавший|leIt
later|позднее|'leItq
launch|начинать|lO:ntS
law|закон, право|lO:
lawyer|юрист, адвокат|'lO:jq
lay|класть|leI
lead|руководство, руководить|li:d
leader|лидер|'li:dq
leadership|руководство, управление|'li:dqSIp
leading|лидирование, руководящий|'li:dIN
league|лига|li:g
learn|узнавать|lq:n
lease|аренда, сдавать в аренду|li:s
leave|уход, уходить, оставлять, покидать|li:v
leaving|отъезд|
leg|нога, ножка|leg
legal|законный|'li:gql
legislation|законы, законодательство|,ledZIs'leISqn
legislative|законодательный|'ledZIslqtIv
legislature|законодательный орган|'ledZIsleItSq
legitimate|обоснованный|lI'dZItImeIt
lend|давать взаймы|lend
length|длина|leNT
let|пускать, разрешать|let
letter|буква, письмо|'letq
level|уровень|'levl
liaison|связь|lI(:)'eIzOn
lib|движение за освобождение|
liberal|либерал, либеральный|'lIbqrql
liberation|освобождение|,lIbq'reISqn
library|библиотека|'laIbrqrI
licence|лицензия|'laIsqns
lie|ложь, лгать|laI
life|жизнь|laIf
lift|повышение, поднимать|lIft
light|светлый, легкий, светить|laIt
like|подобный, нравиться|laIk
likely|вероятно, правдоподобный|'laIklI
limit|предел, ограничивать|'lImIt
limited|ограниченный|'lImItId
line|линия, проводить линии|laIn
liner|лайнер|'laInq
link|звено, связь, связывать|lINk
lion|лев|'laIqn
list|список, вносить в список|lIst
listen|слушать|'lIsn
literary|литературный|'lItqrqrI
little|немного, незначительный|'lItl
live|живой, яркий|laIv
living|живой, средства к жизни|'lIvIN
loan|ссуда|lqun
lobby|лобби|'lObI
local|местный, местная организация|'lqukql
location|местоположение|lqu'keISqn
lock|запирать|lOk
lodge|разместить|lOdZ
lonely|одинокий|'lqunlI
long|длинный, долго|lON
look|взгляд, смотреть|luk
loose|свободный|lu:s
lorry|грузовик|'lOrI
lose|терять|lu:z
loss|потеря|lOs
lot|жребий, судьба|lOt
love|любовь, любить|lAv
low|низкий, тихий, низко|lqu
lower|опускать|'lquq
loyal|лояльный|'lOIql
lucidly|понятно, ясно|
lucky|счастливый|'lAkI
machine|машина|mq'Si:n
machinery|механизмы|mq'Si:nqrI
magazine|журнал|,mxgq'zi:n
magic|магический|'mxdZIk
magistrate|магистрат|'mxdZIstreIt
mail|почта|meIl
main|главный|meIn
mainly|главным образом|'meInlI
maintain|поддерживать|meIn'teIn
maintenance|поддержание|'meIntqnqns
major|большой, основной|'meIdZq
majority|большинство|mq'dZOrItI
make|производить|meIk
maker|производитель|'meIkq
male|мужчина, мужской|meIl
man|человек, мужчина|mxn
manage|управлять|'mxnIdZ
management|управление|'mxnIdZmqnt
manager|управляющий|'mxnIdZq
manifesto|манифест|,mxnI'festqu
manner|образ действия|'mxnq
manufacture|производство, производить|,mxnju'fxktSq
many|многие|'menI
march|марш, маршировать|mQ:tS
margin|резерв|'mQ:dZIn
mark|отмечать|mQ:k
market|рынок ,сбывать|'mQ:kIt
marriage|брак|'mxrIdZ
marry|жениться|'mxrI
marshal|маршал|'mQ:Sql
mass|масса|mxs
massive|массивный|'mxsIv
master|мастер, хозяин|'mQ:stq
match|матч|mxtS
material|материал|mq'tIqrIql
materialize|материализовать, осуществлять|mq'tIqrIqlaIz
matter|материя, дело, случай|'mxtq
maximum|максимум|'mxksImqm
may|мочь|meI
mayor|мэр|mFq
mean|означать|mi:n
means|способ, средства|mi:nz
meantime|между тем|'mi:n'taIm
meanwhile|тем временем|'mi:n'waIl
measure|мера, измерять|'meZq
meat|мясо|mi:t
medical|медицинский|'medIkql
medium|способ|'mi:djqm
meet|встречать|mi:t
meeting|митинг|'mi:tIN
member|член|'membq
membership|членство|'membqSIp
memory|память|'memqrI
menace|опасность|'menqs
mental|умственный|'mentl
mention|упоминать, упоминание|'menSqn
merchant|торговец|'mq:tSqnt
merely|единственно|'mIqlI
merger|слияние|'mq:dZq
message|послание|'mesIdZ
metal|металл|'metl
method|метод|'meTqd
metropolitan|столичный|,metrq'pOlItqn
midday|полдень|'mIddeI
middle|середина, средний|'mIdl
midnight|полночь|'mIdnaIt
mighty|мощный|'maItI
mile|миля|maIl
military|военный|'mIlItqrI
milk|молоко|mIlk
mill|завод, фабрика|mIl
million|миллион|'mIljqn
mind|ум, разум|maInd
mine|шахта, производить горные работы|maIn
miner|шахтер|'maInq
minister|министр|'mInIstq
ministry|министерство|'mInIstrI
minor|меньший|'maInq
minority|меньшинство|maI'nOrItI
minute|минута|maI'nju:t
mirror|зеркало|'mIrq
miss|пропустить|mIs
missile|ракета|'mIsaIl
mission|миссия|'mISqn
mistake|ошибка|mIs'teIk
mix|смешивать|mIks
model|модель|'mOdl
moderate|умеренный|'mOdqreIt
modern|современный|'mOdqn
modest|скромный|'mOdIst
moment|момент|'mqumqnt
money|деньги|'mAnI
monopoly|монополия|mq'nOpqlI
month|месяц|mAnT
moon|луна|mu:n
moral|мораль, моральный|'mOrql
more|больше|mO:
morning|утро|'mO:nIN
mortgage|заклад, залог|'mO:gIdZ
most|самый, наиболее|mqust
mostly|главным образом|'mqustlI
mother|мать|'mADq
motion|движение, ход|'mquSqn
motor|мотор|'mqutq
mount|взбираться|maunt
mountain|гора|'mauntIn
move|движение, двигаться|mu:v
movement|движение|'mu:vmqnt
much|много, очень, почти|mAtS
municipal|муниципальный|mju(:)'nIsIpql
murder|убийство, убивать|'mq:dq
museum|музей|mju(:)'zIqm
music|музыка|'mju:zIk
must|выражает долженствование|mAst
mutual|взаимный, общий|'mju:tjuql
my|мой|maI
myself|себе, себя, собой|maI'self
name|имя, название, называть, упоминать|neIm
nation|страна, государство|'neISqn
national|национальный|'nxSqnl
nationalist|националист|'nxSnqlIst
natural|естественный|'nxtSrql
nature|природа|'neItSq
naval|морской|'neIvql
near|близкий, недалеко,  у,  возле|nIq
nearby|поблизости|'nIqbaI
nearly|почти|'nIqlI
necessarily|обязательно|'nesIsqrIlI
necessary|необходимо|'nesIsqrI
necessity|необходимость|nI'sesItI
neck|шея, ворот|nek
need|потребность, нуждаться|ni:d
neglect|пренебрегать|nI'glekt
negotiate|договариваться|nI'gquSIeIt
negotiation|переговоры|nI,gquSI'eISqn
negotiator|представитель на переговорах|nI'gquSIeItq
neighbour|сосед|'neIbq
neighbourhood|соседство|'neIbqhud
neither|ни тот, ни другой|'naIDq
neither ...nor|ни...ни|
net|чистый, общий|net
network|сеть|'netwq:k
neutron|нейтрон|'nju:trOn
never|никогда|'nevq
nevertheless|все же, тем не менее|,nevqDq'les
new|новый|nju:
newly|вновь|'nju:lI
news|новость|nju:z
newspaper|газета|'nju:s,peIpq
next|следующий|nekst
nice|приятный, тонкий|naIs
night|ночь|naIt
nine|девять|naIn
no|никакой|nquz
nobody|никто|'nqubqdI
nomination|выдвижение кандидатуры|,nOmI'neISqn
none|никто|nAn
nor|и не, также не|nO:-
normal|нормальный|'nO:mql
normally|обычно|'nO:mqlI
north|северный|nO:T
northern|северный|'nO:Dqn
not|ни, не|nOt
note|записка, замечать|nqut
nothing|ничего|'nATIN
notice|внимание, отмечать|'nqutIs
now|теперь, сейчас|nau
nuclear|ядерный|'nju:klIq
number|число|'nAmbq
nurse|няня, сиделка|nq:s
object|возражать|'ObdZIkt
objection|возражение|qb'dZekSqn
objective|цель|qb'dZektIv
observe|наблюдать|qb'zq:v
observer|наблюдатель|qb'zq:vq
obtain|добиваться|qb'teIn
obvious|очевидный|'ObvIqs
obviously|очевидно|
occasion|случай|q'keIZqn
occupation|занятие|,Okju'peISqn
occupy|занимать|'OkjupaI
occur|случаться|q'kq:
ocean|океан|'quSqn
odd|нечетный|Od
of|за|Ov
offence|нарушение|q'fens
offer|предложение, предлагать|'Ofq
office|должность|'OfIs
officer|офицер|'OfIsq
official|официальный, чиновник|q'fISql
offset|смещенный|'Ofset
often|часто|'Ofn
oil|нефть|OIl
old|старый|quld
on|на, по|On
on behalf of|от имени|
once|однажды|wAns
one|единый|wAn
only|единственный, только|'qunlI
open|открывать, открытый|'qupqn
opening|отверстие, начальный|'qupnIN
opera|опера|'Opqrq
operate|действовать|'OpqreIt
operating|управляющий|'OpqreItIN
operation|операция|,Opq'reISqn
operator|оператор|'OpqreItq
opinion|мнение|q'pInjqn
opponent|соперник|q'pqunqnt
opportunity|возможность|,Opq'tju:nItI
oppose|противиться|q'pquz
opposite|противоположный|'OpqzIt
opposition|противодействие|,Opq'zISqn
oppression|притеснение|q'preSqn
optimism|оптимизм|'OptImIzm
or|или|O:
orchestra|оркестр|'O:kIstrq
order|порядок, приказывать|'O:dq
orderly|аккуратный|'O:dqlI
ordinary|обычный|'O:dnrI
organization|организация|,O:gqnaI'zeISqn
organize|организовывать|'O:gqnaIz
organizer|организатор|'O:gqnaIzq
original|оригинальный|q'rIdZqnl
other|другой|'ADq
otherwise|иначе|'ADqwaIz
ought|долженствование|O:T
our|наш|'auq
out|внешний|aut-
outcome|результат|'autkAm
outlaw|объявлять вне закона|'autlO:
output|выпуск|'autput
outside|внешний, снаружи|'aut'saId
outstanding|выдающийся|aut'stxndIN
over|верхний, всеобщий|'quvq-
overall|всеобщий|,quvqr'O:l
overcome|преодолеть|,quvq'kAm
overlook|надзирать|,quvq'luk
overnight|накануне вечером|'quvq'naIt
oversea|заморский|'quvq'si:z
overtime|сверхурочное время|'quvqtaIm
overwhelming|несметный|,quvq'welmIN
own|собственный, владеть|qun
owner|владелец|'qunq
ownership|собственность|'qunqSIp
oxygen|кислород|'OksIdZqn
pace|шагать|'peIsI
pacific|мирный|pq'sIfIk
pack|пакет, упаковывать|pxk
package|пакет|'pxkIdZ
pact|пакт|pxkt
page|страница|peIdZ
paint|красить|peInt
painter|художник|'peIntq
painting|живопись|'peIntIN
pair|пара|pFq
palace|дворец|'pxlIs
panel|комиссия|'pxnl
paper|бумага|'peIpq
parade|парад|pq'reId
parent|родитель|'pFqrqnt
parliament|парламент|'pQ:lqmqnt
parliamentary|парламентский|,pQ:lq'mentqrI
part|разделять, часть|pQ:t
participate|участвовать|pQ:'tIsIpeIt
participation|участие|pQ:,tIsI'peISqn
particular|особый|pq'tIkjulq
particularly|особенно|pq'tIkjulqlI
partly|частично|'pQ:tlI
partner|участник|'pQ:tnq
party|партия|'pQ:tI
pass|проход, проходить|pQ:s
passage|переход|'pxsIdZ
passenger|пассажир|'pxsIndZq
past|прошлое, прошлый|pQ:st
patient|пациент|'peISqnt
patriotic|патриотический|,pxtrI'OtIk
pattern|модель|'pxtqn
pay|плата, платить|peI
payment|платеж|'peImqnt
peace|мир|pi:s
peaceful|мирный|'pi:sful
peak|пик, вершина|pi:k
penalty|штраф, наказание|'penltI
pending|во время, в течение|'pendIN
pension|пенсия|'penSqn
pensioner|пенсионер|'penSqnq
people|нация, люди|'pi:pl
per|в, на, с|pq:
percentage|процент|pq'sentIdZ
perform|исполнять|pq'fO:m
performance|исполнение|pq'fO:mqns
perhaps|возможно|pq'hxps
period|период|'pIqrIqd
permanent|постоянный|'pq:mqnqnt
permission|разрешение|pq'mISqn
permit|разрешать, разрешение|'pq:mIt
person|человек|'pq:sn
personal|личный|'pq:snl
personality|индивидуальность|,pq:sq'nxlItI
personnel|персонал|,pq:sq'nel
persuade|убеждать|pq'sweId
petition|петиция|pI'tISqn
petrol|бензин|'petrql
philosophy|философия|fI'lOsqfI
phrase|фраза|freIz
pianist|пианист|'pIqnIst
pick|выбирать|pIk
picket|пикет, пикетировать|'pIkIt
picture|картина|'pIktSq
piece|кусок|pi:s
pilot|пилот|'paIlqt
pink|розовый|pINk
pit|яма, шахта|pIt
place|место, помещать|pleIs
plan|план, планировать|plxn
plane|самолет|pleIn
planned|плановый|plxnd
planning|планирование|
plant|завод, установка|plQ:nt
plastic|пластмасса, пластичный|'plxstIk
plate|плита|pleIt
play|игра, играть|pleI
player|музыкант|'pleIq
playing|игра|'pleIN
plead|выступать в суде|pli:d
please|угождать|pli:z
pleased|довольный|pli:zd
pledge|залог, обязательство, закладывать|pledZ
plenty|множество|'plentI
plot|заговор|plOt
plus|плюс|plAs
poet|поэт|'pquIt
point|пункт, точка, указывать|pOInt
pole|полюс|pqul
police|полиция|pq'li:s
policeman|полицейский|pq'li:smqn
policy|политика, курс|'pOlIsI
political|политический|pq'lItIkql
politically|политически|pq'lItIkqlI
politics|политика|'pOlItIks
poll|список избирателей|pOl
poor|бедный|puq
popular|народный|'pOpjulq
population|население|,pOpju'leISqn
port|порт|pO:t
portrait|портрет|'pO:trIt
position|положение|pq'zISqn
positive|положительный|'pOzqtIv
possess|обладать|pq'zes
possibility|вероятность|,pOsq'bIlItI
possible|вероятный|'pOsqbl
possibly|возможно|'pOsqblI
post|столб, почта|pqust
postal|почтовый|'pqustql
poster|плакат|'pqustq
postman|почтальон|'pqustmqn
postpone|отсрочивать|peust'pqun
potential|потенциал, потенциальный|pqu'tenSql
pound|фунт|paund
poverty|бедность|'pOvqtI
power|сила|'pauq
powerful|сильный|'pauqful
practical|практический|'prxktIkql
practice|практика|'prxktIs
practitioner|практикующий врач|prxk'tISnq
praise|похвала, хвалить|preIz
predict|предсказывать|prI'dIkt
prefer|предпочитать|prI'fq:
preference|предпочтение|'prefqrqns
premier|министр|'premjq
premium|премия|'pri:mjqm
preparation|приготовление|,prepq'reISqn
prepare|подготавливать|prI'pFq
prescription|распоряжение|prIs'krIpSqn
presence|присутствие|'prezns
present|подарок|prI'zent
preserve|сохранять|prI'zq:v
president|президент|'prezIdqnt
press|пресса, навязывать|pres
pressure|давление|'preSq
prestige|престиж|pres'ti:Z
pretty|привлекательный|'prItI
prevail|торжествовать|prI'veIl
prevent|предотвращать, препятствовать|prI'vent
previous|предшествующий|'pri:vjqs
previously|предварительно|'pri:vjqslI
primarily|главным образом|'praImqrIlI
primary|первичный|'praImqrI
prime|главный|praIm
prince|принц|prIns
princess|принцесса|prIn'ses
principle|принцип, основной|'prInsqpl
print|печатать|prInt
prison|тюрьма|'prIzn
prisoner|заключенный|'prIznq
private|частный|'praIvIt
prize|приз|praIz
probably|вероятно|'prObqblI
problem|проблема|'prOblqm
procedure|процедура|prq'si:dZq
proceed|продолжать|prq'si:d
proceedings|труды, записки|
process|процесс|'prquses
procession|процессия|prq'seSqn
proclaim|провозглашать|prq'kleIm
produce|производить|'prOdju:s
producer|режиссер|prq'dju:sq
product|продукция|'prOdAkt
production|производство|prq'dAkSqn
productivity|производительность|,prOdAk'tIvItI
profession|профессия|prq'feSqn
professional|профессиональный|prq'feSqnl
professor|профессор|prq'fesq
profit|прибыль|'prOfIt
programme|программа|'prqugrxm
progress|прогресс|'prqugrqs
progressive|прогрессивный|prq'gresIv
project|проект|'prOdZekt
prominent|выдающийся|'prOmInqnt
promise|обещание, обещать|'prOmIs
promote|продвигать, повышать в должности|prq'mqut
promotion|поощрение|prq'mquSqn
prompt|побуждать|prOmpt
propaganda|пропаганда|,prOpq'gxndq
proper|присущий|'prOpq
properly|должным образом|'prOpqlI
property|собственность|'prOpqtI
proportion|пропорция|prq'pO:Sqn
proposal|предложение|prq'pquzql
propose|предлагать|prq'pquz
prosecution|судебное расследование|,prOsI'kju:Sqn
prospect|перспектива|'prOspekt
protect|защищать|prq'tekt
protection|защита|prq'tekSqn
protest|протест, протестовать|'prqutest
prove|доказывать|pru:v
provide|обеспечивать|prq'vaId
provided|при условии|prq'vaIdId
province|область, провинция|'prOvIns
provincial|провинциальный|prq'vInSql
provisional|временный|prq'vIZqnl
publication|опубликование|,pAblI'keISqn
publicity|гласность|pAb'lIsItI
publicly|публично|'pAblIklI
publish|публиковать|'pAblIS
publisher|издатель|'pAblISq
pull|тянуть|pul
punishment|наказание|'pAnISmqnt
pupil|ученик|'pju:pl
purchase|покупка, покупать|'pq:tSqs
purpose|цель|'pq:pqs
pursue|преследование|pq'sju:
push|толкать|puS
put|помещать|put
qualify|квалифицировать|'kwOlIfaI
quality|качество|'kwOlItI
quantity|количество|'kwOntItI
quarter|четверть|'kwO:tq
question|вопрос, проблема|'kwestSqn
quick|быстрый, скорый|kwIk
quickly|быстро, скоро|'kwIklI
quiet|тишина, спокойствие, тихий, спокойный|'kwaIqt
quietly|тихо, спокойно|'kwaIqtlI
quite|совершенно, вполне|kwaIt
race|гонка, участвовать в гонке|reIs
racial|расовый|'reISql
racism|расизм|'reIsIzm
racist|расист|'reIsIst
radiation|радиация|,reIdI'eISqn
radio|радио|'reIdIqu
rail|рельс|reIl
railway|железная дорога|'reIlweI
rain|дождь|reIn
raise|увеличение, поднимать|reIz
rally|митинг|'rxlI
ranch|ранчо|rQ:ntS
range|область, располагать|reIndZ
rank|ряд, чин, выстраивать|rxNk
rate|ставка, тариф|reIt
rather|лучше|'rQ:Dq
reach|достигать|ri:tS
reaction|реакция|rI(:)'xkSqn
read|изучать|ri:d
reader|читатель|'ri:dq
reading|чтение, начитанность, эрудиция|'ri:dIN
ready|готовый|'redI
reaffirm|вновь подтверждать|'ri:q'fq:m
real|реальный|reI'Q:l
realistic|реалистический|rIq'lIstIk
reality|действительность|rI(:)'xlItI
realize|реализовывать|'rIqlaIz
really|действительно|'rIqlI
reason|причина|'ri:zn
reasonable|разумный|'ri:znqbl
rebel|повстанец|rI'bel
recall|отзывать|rI'kO:l
receive|получать|rI'si:v
recent|недавний|'ri:snt
recently|недавно|'ri:sntlI
recognition|узнавание|,rekqg'nISqn
recognize|узнавать|'rekqgnaIz
recommend|рекомендовать|,rekq'mend
recommendation|рекомендация|,rekqmen'deISqn
record|записывать|rI'kO:d
recovery|выздоровление|rI'kAvqrI
recruit|вербовать, нанимать|rI'kru:t
red|красный|red
reduce|снижать|rI'dju:s
reduction|снижение|rI'dAkSqn
refer|отсылать, ссылаться|rI'fq:
reference|ссылка, упоминание|'refrqns
reflect|отражать|rI'flekt
reform|реформа, реформировать|'ri:'fO:m
refusal|отказ|rI'fju:zql
refuse|отказывать|'ri:'fju:z
regard|рассматривать|rI'gQ:d
regardless|независимо от|rI'gQ:dlIs
regime|режим|reI'Zi:m
region|область|'ri:dZqn
regional|региональный|'ri:dZqnl
register|регистрировать|'redZIstq
regular|регулярный|'regjulq
regularly|регулярно|
regulation|регулирование|,regju'leISqn
reinstatement|восстановление|'ri:In'steItmqnt
reject|отвергать|'ri:dZekt
relate|относиться, связывать|rI'leIt
relation|отношение|rI'leISqn
relationship|родство|rI'leISqnSIp
relative|относительный|'relqtIv
relatively|относительно|'relqtIvlI
release|освобождение, освобождать|rI'li:s
relief|облегчение|rI'li:f
religious|религиозный|rI'lIdZqs
remain|оставаться|rI'meIn
remarkable|замечательный|rI'mQ:kqbl
remember|помнить|rI'membq
remind|напоминать|'rImaInd
remote|отдаленный|rI'mqut
removal|перемещение|rI'mu:vql
remove|перемещать|rI'mu:v
renew|обновлять|rI'nju:
rent|арендная плата|rent
repair|ремонт, ремонтировать|rI'pFq
repeat|повторять|rI'pi:t
repeatedly|неоднократно|rI'pi:tIdlI
replace|возвращать|rI'pleIs
reply|ответ, отвечать|rI'plaI
report|доклад, сообщать|rI'pO:t
reporter|репортер|rI'pO:tq
represent|изображать|,reprI'zent
representation|изображение|,reprIzen'teISqn
representative|представитель, представляющий|,reprI'zentqtIv
republic|республика|rI'pAblIk
republican|республиканец, республиканский|rI'pAblIkqn
request|просить, просьба|rI'kwest
require|требовать|rI'kwaIq
requirement|требование|rI'kwaIqmqnt
rescue|спасение, спасать|'reskju:
research|исследование, исследовать|rI'sq:tS
reserve|резерв, сберегать|rI'zq:v
resident|резидент|'rezIdqnt
resign|уходить в отставку|'ri:'saIn
resignation|уход в отставку|,rezIg'neISqn
resistance|сопротивление|rI'zIstqns
resolution|резолюция|,rezq'lu:Sqn
resolve|решать|rI'zOlv
resort|обращение, обращаться|rI'zO:t
resource|ресурсы|rI'sO:s
respect|уважать, уважение|rIs'pekt
response|реакция, ответ|rIs'pOns
responsibility|ответственность|rIs,pOnsq'bIlItI
responsible|ответственный|rIs'pOnsqbl
rest|отдых|rest
restaurant|ресторан|'restqrO:N
restore|возвращать|rIs'tO:
restraint|сдержанность|rIs'treInt
restrict|ограничивать|rIs'trIkt
restriction|ограничение|rIs'trIkSqn
result|результат|rI'zAlt
resume|возобновлять|'rezju(:)meI
retail|пересказывать|ri:'teIl
retain|удерживать|rI'teIn
retire|удаляться|rI'taIq
retirement|отставка|rI'taIqmqnt
return|возвращение, возвращать|rI'tq:n
reveal|обнаруживать|rI'vi:l
revenue|доход|'revInju:
reverse|менять|rI'vq:s
review|обзор, рассматривать|rI'vju:
revise|пересматривать|rI'vaIz
revolution|революция, переворот|,revq'lu:Sqn
revolutionary|революционер, революционный|,revq'lu:SnqrI
reward|награда, награждать|rI'wO:d
rich|богатый|rItS
rid|освобождать|rId
ride|прогулка|raId
right|правильность, справедливый, справедливо|raIt
ring|кольцо, окружать|rIN
riot|мятеж|'raIqt
rise|вставать, увеличение|raIz
risk|риск, рисковать|rIsk
rival|соперник, соперничающий|'raIvql
river|река|'rIvq
road|дорога|rqud
robbery|грабеж|'rObqrI
rock|скала|rOk
rocket|ракета, пускать ракету|'rOkIt
rod|стержень|rOd
role|роль|rqul
roof|крыша|ru:f
room|комната|ru:m
root|корень|ru:t
round|круг, круглый, вокруг, кругом|raund
route|маршрут|ru:t
row|гребля, грести|rqu
royal|королевский|'rOIql
rugby|регби|'rAgbI
rule|правило, править|ru:l
run|бег, бежать|rAn
sabotage|саботаж, саботировать|'sxbqtQ:Z
sack|класть|sxk
safe|безопасный|seIf
safeguard|гарантия|'seIfgQ:d
safety|безопасность|'seIftI
sale|продажа|seIl
salmon|лосось|'sxmqn
satisfaction|удовлетворение|,sxtIs'fxkSqn
satisfactory|удовлетворительный|,sxtIs'fxktqrI
satisfy|удовлетворять|'sxtIsfaI
save|кроме, за исключением, спасать|seIv
saving|экономия|'seIvIN
say|говорить|seI
scale|масштаб|skeIl
scandal|скандал|'skxndl
scene|место действия|si:n
schedule|расписание, составлять расписание|'Sedju:l
scheme|проект|ski:m
school|школа|sku:l
science|наука|'saIqns
scientist|ученый|'saIqntIst
score|счет, выигрывать|skO:
screen|экран, экранировать|skri:n
sea|море|si:
seaman|моряк|'si:mqn
search|поиски, искать|sq:tS
season|время года|'si:zn
seat|сиденье|si:t
second|запасный, второй, поддерживать|'sekqnd
secret|секрет, секретный|'si:krIt
secretary|секретарь|'sekrqtrI
section|секция|'sekSqn
sector|сектор|'sektq
secure|страховать|sI'kjuq
security|безопасность|sI'kjuqrItI
see|видеть|si:
seed|источник|si:d
seek|искать|si:k
seem|казаться|si:m
seize|хватать|si:z
select|отбирать|sI'lekt
selection|отбор|sI'lekSqn
sell|торговать|sel
senate|сенат|'senIt
senator|сенатор|'senqtq
send|направлять|send
senior|старший|'si:njq
sense|чувство|sens
sensible|чувствующий|'sensqbl
sentence|приговор, приговаривать|'sentqns
sentiment|настроение|'sentImqnt
separate|отдельный|'sepqreIt
series|серия|'sIqri:z
serious|серьезный|'sIqrIqs
seriously|серьезно|
servant|служащий|'sq:vqnt
serve|служить|sq:v
service|работа, служба|'sq:vIs
session|сессия|'seSqn
set|набор, комплект, ряд, группа|set
setting|окружение|'setIN
settle|решать, поселяться|'setl
settlement|урегулирование|'setlmqnt
seven|семь|'sevn
seventh|седьмой|'sevnT
several|несколько, различный|'sevrql
severe|строгий, жестокий|sI'vIq
sex|секс|seks
sexual|сексуальный|'seksjuql
share|делить, распределять, участвовать|SFq
shareholder|акционер|'SFq,hquldq
sharp|крутой|SQ:p
sharply|резко|
she|она|Si:-
sheep|овца|Si:p
sheet|лист|Si:t
sheriff|шериф|'SerIf
shift|смена, перемещать|SIft
ship|корабль,  перевозить|SIp
shipbuilding|кораблестроение|'SIp,bIldIN
shirt|рубашка|Sq:t
shock|удар, поражать|SOk
short|короткий|SO:t
shortage|недостаток|'SO:tIdZ
shortly|вскоре|'SO:tlI
shot|выстрел|SOt
shout|крик, кричать|Saut
show|показ, показывать|Squ
shut|закрывать|SAt
side|сторона|saId
sight|зрение|saIt
sign|подписывать, признак|saIn
significance|значение|sIg'nIfIkqns
significant|значительный|sIg'nIfIkqnt
silent|молчаливый|'saIlqnt
similar|похожий|'sImIlq
simple|простой|'sImpl
simply|просто|'sImplI
since|с тех пор, с, после|sIns
sing|петь|sIN
singer|певец|'sINq
single|единственный|'sINLgl
sir|сэр|sq:
sit|сидеть|sIt
site|местоположение|saIt
situation|ситуация|,sItju'eISqn
six|шесть|sIks
size|размер|saIz
skill|мастерство|skIl
skilled|искусный|skIld
skin|кожа|skIn
sky|небо|skaI
sleep|спать|sli:p
slight|поверхностный|slaIt
slightly|слегка|'slaItlI
slip|скольжение, скользить|slIp
slogan|лозунг|'slqugqn
slow|медленный, замедлять|slqu
slowly|медленно|'sloulI
slum|трущоба|slAm
small|маленький|smO:l
smash|разбить|smxS
smoke|курение, дымить|smquk
snow|снег|snqu
so|поэтому, таким образом|squ
social|общественный|'squSql
society|общество|sq'saIqtI
soldier|солдат|'squldZq
solid|твердый|'sOlId
solidarity|солидарность|,sOlI'dxrItI
solution|решение|sq'lu:Sqn
solve|решать|sOlv
some|некоторое количество|sAm
somebody|кто-то|'sAmbqdI
someone|кто-нибудь|'sAmwAn
something|что-то|'sAmTIN
sometimes|иногда|'sAmtaImz
somewhat|кое-что|'sAmwOt
son|сын|sAn
song|песня|sON
soon|скоро|su:n
sorry|огорченный|'sOrI
sort|вид|sO:t
sound|звук, звучать|saund
source|источник|sO:s
south|к югу, южный|sauT
southern|южный|'sADqn
space|пространство, пространственный|speIs
spark|искра, искрить|spQ:k
speak|говорить|spi:k
speaker|оратор|'spi:kq
special|особый|'speSql
specific|специфический|spI'sIfIk
specifically|специфически|
speculation|размышление|,spekju'leISqn
speech|речь|spi:tS
speed|скорость|spi:d
spell|сменять|spel
spend|тратить|spend
spirit|дух|'spIrIt
spite|злость|spaIt
split|раскалывать|splIt
spokesman|представитель|'spquksmqn
sponsor|организатор|'spOnsq
sport|спорт|spO:t
spot|пятно, пачкать|spOt
spray|брызги, обрызгивать|spreI
spread|распространение, распространять|spred
spring|прыжок|sprIN
spur|стимул|spq:
spy|шпион|spaI
square|квадрат, квадратный|skwFq
stable|устойчивый|'steIbl
stadium|стадион|'steIdjqm
staff|штат|stQ:f
stage|сцена, ставить|steIdZ
stake|ставка, делать ставку|steIk
stand|ларек, стойка, стоять, находиться|stxnd
standard|стандарт, стандартный|'stxndqd
star|звезда|stQ:
start|старт, начало, отправляться, начинаться|stQ:t
state|государство, излагать|steIt
statement|высказывание|'steItmqnt
station|станция|'steISqn
statistics|статистика|stq'tIstIks
status|статус|'staeItqs
stay|оставаться|steI
steady|прочный|'stedI
steal|кража, воровать|sti:l
steel|сталь, стальной|sti:l
stem|стержень|stem
step|ступень, шагать|step
sterling|стерлинговый, фунт стерлингов|'stq:lIN
steward|стюард|stjuqd
still|однако, все еще, спокойно, тихий|stIl
stock|запас, снабжать|stOk
stone|камень, каменный|stqun
stop|остановка, останавливать|stOp
stoppage|остановка, задержка|'stOpIdZ
store|изобилие|stO:
storm|буря, гроза|stO:m
story|повесть, рассказ|'stO:rI
straight|прямо|streIt
strange|незнакомый, необычный|streIndZ
strategic|стратегический|strq'ti:dZIk
strategy|стратегия|'strxtIdZI
street|улица|stri:t
strength|сила|streNT
strengthen|усиливать|'streNTqn
stress|давление, нажим, подчеркивать|stres
stretch|вытягивание|stretS
strike|удар, ударять|straIk
strive|стараться|straIv
stroke|бросок|strquk
strong|сильный|strON
strongly|решительно|
structure|структура|'strAktSq
struggle|бороться|'strAgl
student|студент|'stju:dqnt
study|изучение, изучать|'stAdI
style|стиль|staIl
sub-committee|подкомитет|
subject|предмет, подчинять|'sAbdZIkt
submarine|подводная лодка|,sAbmq'ri:n
submit|подчиняться|sqb'mIt
subsidiary|вспомогательный|sqb'sIdjqrI
subsidy|субсидия|'sAbsIdI
substantial|прочный|sqb'stxnSql
substantially|основательно|sqb'stxnSqlI
succeed|достигать цели|sqk'si:d
success|успех|sqk'ses
successful|успешный|sqk'sesful
succession|последовательность|sqk'seSqn
such|таковой, подобный|sAtS
sudden|внезапный|'sAdn
suddenly|внезапно|'sAdnlI
suffer|страдать|'sAfq
sufficient|достаточный|sq'fISqnt
sufficiently|достаточно|
sugar|сахар|'Sugq
suggest|советовать|sq'dZest
suggestion|предложение|sq'dZestSqn
suitable|подходящий|'sju:tqbl
sum|итог, суммировать|sAm
summer|лето|'sAmq
summon|вызывать|'sAmqn
sun|солнце|sAn
supply|снабжать, снабжение|sq'plaI
support|поддержка, поддерживать|sq'pO:t
supporter|сторонник|sq'pO:tq
suppose|полагать|sq'pquz
supreme|верховный|sju(:)'pri:m
sure|уверенный|Suq
surely|несомненно|'SuqlI
surface|поверхность|'sq:fIs
surgeon|хирург|'sq:dZqn
surprise|удивление, удивлять|sq'praIz
surround|окружать|sq'raund
survey|осмотр|sq:'veI
survive|пережить|sq'vaIv
suspect|полагать|sqs'pekt
suspend|приостанавливать|sqs'pend
suspicion|подозрение|sqs'pISqn
sustain|поддерживать|sqs'teIn
sweep|сметать|swi:p
swim|плавать|swIm
swing|качание, качать|swIN
switch|махать|swItS
sympathy|сочувствие|'sImpqTI
symphony|симфония|'sImfqnI
system|система|'sIstIm
table|стол|'teIbl
tactics|тактика|'txktIks
take|захват, захватывать|teIk
taking|овладение|'teIkIN
talent|талант|'txlqnt
talk|беседа, разговаривать|tO:k
tall|высокий|tO:l
tanker|танкер|'txNkq
target|задание|'tQ:gIt
tariff|тариф|'txrIf
task|задача|tQ:sk
taste|вкус|teIst
tax|налог, облагать налогом|txks
taxation|обложение налогом|txk'seISqn
tea|чай|ti:
teach|учить|ti:tS
teacher|учитель|'ti:tSq
team|команда|ti:m
tear|разрывать|tFq
technical|технический|'teknIkql
technician|техник|tek'nISqn
technique|техника|tek'ni:k
technology|технология|tek'nOlqdZI
telephone|телефон, звонить по телефону|'telIfqun
television|телевидение|'telI,vIZqn
tell|рассказывать|tel
temperature|температура|'temprItSq
temporary|временный|'tempqrqrI
ten|десять|ten
tenant|арендатор|'tenqnt
tend|иметь тенденцию|tend
tennis|теннис|'tenIs
tension|напряжение|'tenSqn
term|период, срок|tq:m
terminal|конечный пункт|'tq:mInl
terrible|страшный|'terqbl
territory|территория|'terItqrI
test|испытание, испытывать|test
testimony|свидетельское показание|'testImqnI
textile|ткань|'tekstaIl
than|чем|Dxn
thank|благодарность, благодарить|TxNk
that|что, так как, этот, тот|Dxt
the Commons|палата общин (в Великобритании)|
the Labour Party|лейбористская партия|
theatre|театр|'TIqtq
theft|воровство|Teft
their|их, свой|DFq
theme|тема|Ti:m
themselves|себя, себе|Dqm'selvz
then|тогда, затем|Den
theory|теория|'TIqrI
there|там, туда|DFq
therefore|следовательно|'DFqfO:
they|они|DeI
thing|вещь|TIN
think|думать|TINk
thinking|размышление|'TINkIN
third|треть, третий|Tq:d
this|этот, это|DIs
thoroughly|тщательно|'TArqlI
though|однако, хотя, все же|Dqu
thought|мысль|TO:t
thousand|тысяча|'Tauzqnd
threat|угроза|Tret
threaten|угрожать|'Tretn
three|три|Tri:
through|насквозь, через, сквозь|Tru:
throughout|повсюду, через|Tru(:)'aut
throw|бросок, бросать|Trqu
thus|таким образом|DAs
ticket|квитанция|'tIkIt
tie|узел, связывать|taI
tight|тугой|taIt
time|время|taIm
title|название, называть|'taItl
to|к, в, на|tu:
today|сегодня, сегодняшний день|tq'deI
together|одновременно|tq'geDq
tomorrow|завтра, завтрашний день|tq'mOrqu
ton|тонна|tO:N
tone|тон|tqun
tonight|сегодня вечером|tq'naIt
too|слишком|tu:
toolmaker|инструментальщик|
top|верхушка|tOp
torture|пытка, пытать|'tO:tSq
total|весь, целый, сумма, итог|'tqutl
totally|полностью|
touch|прикосновение, трогать|tAtS
tough|жесткий|tAf
tour|поездка, совершать поездку|tuq
tourist|турист|'tuqrIst
tournament|турнир|'tuqnqmqnt
toward|грядущий, предстоящий|tq'wO:d
tower|башня|'tauq
town|город|taun
township|местечко|'taunSIp
track|след, курс|trxk
trade|занятие|treId
trading|коммерция|'treIdIN
traditional|традиционный|trq'dISqnl
traffic|движение|'trxfIk
trail|хвост|treIl
train|тренировать|treIn
trainer|тренер|'treInq
training|тренировка|'treInIN
transfer|передача, переносить|'trxnsfq(:)
transport|транспорт|trxns'pO:t
trap|окружать|trxp
travel|путешествие, путешествовать|'trxvl
treasure|драгоценность|'treZq
treasury|сокровищница|'trqZqrI
treat|обращаться|tri:t
treatment|обращение|'tri:tmqnt
treaty|договор|'tri:tI
tree|дерево|tri:
tremendous|ужасный|trI'mendqs
trend|направление|trend
trial|испытание|'traIql
tribunal|суд, трибунал|traI'bju:nl
tribute|дань|'trIbju:t
trip|поездка|trIp
triumph|триумф|'traIqmf
troop|войска|tru:p
trouble|беспокойство|'trAbl
truck|грузовик|trAk
true|верный|tru:
trust|доверие|trAst
truth|правда|tru:T
try|попытка, пытаться|traI
turn|поворачивать|tq:n
turnover|переворот|'tq:n,quvq
twelve|двенадцать|twelv
twentieth|двадцатый|'twentIIT
twenty|двадцать|'twentI
two|два|tu:
type|тип|taIp
unable|неспособный|'An'eIbl
unanimously|единодушно|
uncertainty|неуверенность|An'sq:tntI
under|под, у, в, на|'Andq
underground|метро|,Andq'graund
understand|понимать|,Andq'stxnd
understanding|понимание|,Andq'stxndIN
undertake|предпринимать|,Andq'teIk
unemployed|безработный|'AnIm'plOId
unemployment|безработица|'AnIm'plOImqnt
uniform|форма|'ju:nIfO:m
union|союз|'ju:njqn
unionism|профсоюзное движение|'ju:njqnIzm
unionist|член профсоюза|'ju:njqnIst
unit|единица|'ju:nIt
unite|объединять|ju:'naIt
united|соединенный|'ju'naItId
unity|единство|'ju:nItI
unknown|неизвестный|'An'nqun
unless|если не, пока не|qn'les
unlikely|маловероятный|An'laIklI
until|до, пока|qn'tIl
unusual|необычный|An'ju:Zuql
upset|опрокидывать|Ap'set
upwards|больше|'Apwqdz
urban|городской|'q:bqn
urge|понуждать|q:dZ
urgent|срочный|'q:dZqnt
urgently|срочно|
use|использование, использоваться|ju:z
useful|полезный|'ju:sful
usefully|с пользой|
usual|обычный|'ju:Zuql
valley|долина|'vxlI
valuable|ценный|'vxljuqbl
value|ценность|'vxlju:
variety|разнообразие|vq'raIqtI
various|различный|'vFqrIqs
vary|менять|'vFqrI
vast|обширный|vQ:st
vehicle|транспортное средство|'vi:Ikl
verdict|вердикт|'vq:dIkt
version|версия|'vq:Sqn
very|настоящий, очень|'verI
vessel|судно|'vesl
veteran|ветеран|'vetqrqn
vice|порок|'vaIsI
vice-president|вице-президент|'vaIs'prezIdqnt
vicious|порочный|'vISqs
victim|жертва|'vIktIm
victory|победа|'vIktqrI
view|поле зрения, вид, мнение|vju:
village|деревня, село|'vIlIdZ
violence|сила, неистовство, насилие|'vaIqlqns
visit|визит, посещать|'vIzIt
visitor|гость|'vIzItq
vital|жизненный, крайне необходимый|'vaItl
voice|голос|vOIs
volume|объем, масса|'vOljum
voluntary|добровольный|'vOlqntqrI
volunteer|доброволец|,vOlqn'tIq
vote|голосование, голосовать|vqut
voter|избиратель|'vqutq
voting|голосование|'vqutIN
wage|заработная плата|weIdZ
wait|ждать|weIt
walk|походка, ходить|wO:k
walker|скороход|'wO:kq
wall|стена|wO:l
want|нуждаться|wOnt
war|война|wO:
ward|опека|wO:d
warm|теплый, горячий|wO:m
warn|предупреждать|wO:n
warning|предупреждение|'wO:nIN
watch|наблюдать|wOtS
water|вода, водный|'wO:tq
wave|волна|weIv
way|направление|weI
we|мы|wi:
wealth|богатство|welT
weapon|оружие|'wepqn
wear|носить|wFq
weather|погода|'weDq
week|неделя|wi:k
weekend|выходные|'wi:k'end
weekly|еженедельный, еженедельно|'wi:klI
weight|вес груза|weIt
welcome|гостеприимство, приветствовать|'welkqm
welfare|благосостояние|'welfFq
well|хорошо, удачно, здоровый|wel
west|западный, к западу|west
western|западный|'westqn
what|что, то, тот|wOt
whatever|что бы ни|wOt'evq
wheel|колесо, катить|wi:l
when|когда, когда бы ни|wen
where|где, куда|wFq
whether|ли|'weDq
which|который, какой|wItS
while|в то время как, промежуток времени|waIl
white|белый|waIt
who|кто, который|hu:
whole|целый, весь, целое|hqul
whose|чей|hu:z
why|почему|waI
wide|широкий|waId
widely|широко|
widespread|распространенный|'waIdspred
widow|вдова|'wIdqu
wife|жена|waIf
wild|дикий, бурный|waIld
will|воля, завещание|wIl
win|победить, выиграть|wIn
wind|ветер|waInd
window|окно|'wIndqu
wing|крыло|wIN
winner|победитель|'wInq
winter|зима|'wIntq
wish|желание, желать|wIS
with|за, с, у, по|wID
withdraw|отнимать|wID'drO:
within|в пределах, внутри|wI'DIn
without|не считая, кроме|wI'Daut
witness|свидетель, быть свидетелем|'wItnIs
woman|женщина|'wumqn
wonder|интересоваться|'wAndq
wonderful|удивительный|'wAndqful
wood|лес, дерево|wud
word|слово|wq:d
work|работа, труд, работать|wq:k
work-force|рабочая сила|
worker|работник|'wq:kq
working|трудовой|'wq:kIN
world|мир|wq:ld
worry|беспокоить|'wArI
worth|цена, стоимость, стоящий|wq:T
wound|рана, ранить|waund
write|писать|raIt
writer|писатель|'raItq
writing|письменность|'raItIN
written|письменный, написанный|'rItn
wrong|ошибочный|rON
yard|ярд, двор|jQ:d
year|год|jq:
yesterday|вчера, вчерашний день|'jestqdI
yet|до сих пор, пока что, но, однако|jet
yield|приносить|ji:ld
you|вы, ты|ju:d
young|молодой, новый|jAN
your|ваш, твой|jO:
youth|молодость, молодежь|ju:T
zone|зона|zqun
