'cello|виолончель|'tSelqu
Algerian|алжирец, алжирский|xl'dZIqrIqn
Alpine|альпийский|'xlpaIn
Anglican|англиканский|'xNglIkqn
Angolan|ангольский|
Asian|азиат, азиатский|'eISn
Australian|австралиец|O'streIlIqn
Austrian|австрийский|
Bible|библия|'baIbl
Canadian|канадец|kq'neIdIqn
Charterhouse|Чартерхаус (дом престарелых в Лондоне)|'tSQ:tqhaus
Chilean|чилийский|'tSIlIqn
Concorde|самолет"Конкорд"|
Czech|чешский|tSek
Danish|датский|'deInIS
Dominican|доминиканский|
Dutch|голландский|
EEC|Европейское экономическое сообщество|
Egyptian|египетский|I'dZIpSqn
Englishman|англичанин|'INglISmqn
French|французский язык|frentS
Gypsy|цыган|'dZIpsI
Haitian|гаитяне|'heISjqn
Hungarian|венгерский|hAN'gFqrIqn
Indian|индиец, индийский|'IndIqn
Irishman|ирландец|'aIqrISmqn
Israeli|еврей, еврейский|
Italian|итальянец, итальянский|I'txlIqn
Jamaican|ямайский|
Japanese|японец|,dZxpq'ni:z
Jew|еврей|dZu:
Korean|корейский|kq'rIqn
Kremlin|Кремль|'kremlIn
Madame|мадам|
Majesty|величество|'mxdZIstI
Mexican|мексиканский|'meksIkqn
Midlands|центральные графства Англии|
Olympics|олимпийские игры|
Orient|Восток|'O:rIent
PM|премьер-министр|
Palestinian|палестинский|,pxlqs'tInIqn
Progressive|член Прогрессивной партии|prq'gresIv
Roman|римский|'rqumqn
Scot|шотландец|skOt
Spaniard|испанец|'spxnjqd
UN (United Nations)|Организация Объединенных наций (ООН)|
Welsh|валлийский, уэльский|welS
Yankee|янки|'jxNkI
a.m.|до полудня|
abolish|отменять|q'bOlIS
absent|отсутствующий|'xbsqnt
abstention|воздержание|qb'stenS(q)n
abuse|злоупотреблять|q'bju:s
abusive|оскорбительный|q'bju:sIv
academic|академический|,xkq'demIk
acceptable|приемлемый|qk'septqbl
acclaim|провозглашать|q'kleIm
accomplish|выполнять|q'kOmplIS
accord|согласие|q'kO:d
accordance|соответствие|q'kO:dqns
accordingly|соответственно|q'kO:dINlI
accountability|ответственность|q,kauntq'bIlItI
accountable|ответственный|q'kauntqbl
accusation|обвинение|,xkju(:)'zeIS(q)n
ace|очко|eIs
acknowledgement|достижение|qk'nOlIdZmqnt
acquisition|приобретение|,xkwI'zIS(q)n
acquit|оправдывать|q'kwIt
acre|акр|'eIkq
across|поперек|q'krOs
actively|активно, деятельно|
acute|острый, проницательный|q'kju:t
adaptation|приспособление|,xdxp'teIS(q)n
adequacy|достаточность|'xdIkwqsI
adhere|твердо держаться|qd'hIq
adjoin|примыкать|q'dZOIn
adjourn|отсрочить|q'dZq:n
adjournment|отсрочка, перерыв|q'dZq:nmqnt
adjust|улаживать|q'dZAst
adjustment|регулирование|q'dZAstmqnt
administer|управлять|qd'mInIstq
administrator|администратор|qd'mInIstreItq
admirable|замечательный|'xdmqrqbl
admiralty|адмиралтейство|'xdmqrqltI
admire|восхищаться|qd'maIq
advancement|продвижение|qd'vQ:nsmqnt
adverse|враждебный|'xdvq:s
adversely|враждебно|
advise|советовать|qd'vaIz
adviser|советник|qd'vaIzq
affected|пораженный|q'fektId
affection|привязанность, любовь|q'fekS(q)n
affidavit|письменное показание|,xfI'deIvIt
affiliated|присоединенный|
affiliation|прием в члены|q,fIlI'eIS(q)n
affirm|утверждать|q'fq:m
affray|пугать|q'freI
affront|оскорбление|q'frAnt
afraid|испуганный|q'freId
agenda|повестка дня|q'dZendq
aggravate|ухудшать|'xgrqveIt
aggregate|совокупность|'xgrIgeIt
aggression|агрессия|q'greS(q)n
aggressive|агрессивный|q'gresIv
aggressor|агрессор|q'gresq
agrarian|аграрный|q'grFqrIqn
agreeable|приятный, милый|q'grIqbl
aid|помощь, помогать|eId
ailing|больной|'eIlIN
airborne|авиационный|'FqbO:n
airliner|лайнер|
airplane|самолет|'FqpleIn
alike|подобный|q'laIk
alive|живой|q'laIv
allegedly|по утверждению|
alleviate|смягчать|q'li:vIeIt
allocate|предназначать|'xlqukeIt
alongside|бок о бок|q'lON'saId
amaze|изумлять, поражать|q'meIz
ambition|честолюбие|xm'bIS(q)n
ambitious|честолюбивый|xm'bISqs
amenity|прелесть|q'mi:nItI
amuse|развлекать|q'mju:z
anarchist|анархист|'xnqkIst
ancillary|подчиненный|xn'sIlqrI
angel|ангел|'eIndZql
annually|ежегодно|'xnjuqlI
anomaly|аномалия|q'nOmqlI
anonymous|анонимный|q'nOnImqs
antagonism|антагонизм|xn'txgqnIzm
antique|древний|xn'ti:k
anxiety|беспокойство|xN'zaIqtI
anybody|кто-нибудь, любой|'enI,bOdI
anyway|во что бы то ни стало|'enIweI
anywhere|везде, всюду|'enIwFq
apartment|квартира, комната|q'pQ:tmqnt
apiece|поштучно|q'pi:s
apologize|извиняться|q'pOlqdZaIz
appalling|ужасный, плачевный|q'pO:lIN
apparatus|аппарат|,xpq'reItqs
appreciable|заметно, ощутимо|q'pri:Sqbl
appreciate|оценивать|q'pri:SIeIt
apprentice|ученик|q'prentIs
appropriation|присвоение|q,prquprI'eIS(q)n
approximately|приблизительно|q'prOksImItlI
arch|арка, дуга|'Q:tS
archduke|эрцгерцог|
architect|архитектор|'Q:kItekt
arm|рука|Q:m
armament|вооружение|'Q:mqmqnt
articulate|отчетливо произносить|Q:'tIkjuleIt
artificial|искусственный|,Q:tI'fIS(q)l
artillery|артиллерия|Q:'tIlqrI
artistic|артистический|Q:'tIstIk
aside|в стороне|q'saId
asleep|спящий|q'sli:p
asphyxiation|асфиксия, удушье (мед.)|
aspiration|стремление|,xspq'reIS(q)n
assassination|убийство|q,sxsI'neIS(q)n
assemble|созывать|q'sembl
assertion|утверждение|q'sq:S(q)n
assess|определять размер налога|q'ses
assessment|обложение|q'sesmqnt
asset|имущество|'xset
assign|назначать|q'saIn
assignment|назначение|q'saInmqnt
assumption|предположение|q'sAmpS(q)n
asylum|убежище, приют|q'saIlqm
atmospheric|атмосферный|,xtmqs'ferIk
attain|достигать|q'teIn
attraction|притяжение|q'trxkS(q)n
attribute|приписывать|'xtrIbju:t
auditorium|зрительный зал|,O:dI'tO:rIqm
austerity|строгость|Os'terItI
authorize|санкционировать|'O:TqraIz
auto|автомобиль|'O:tqu-
automatic|автоматический|,O:tq'mxtIk
automatically|автоматически|,O:tq'mxtIk(q)lI
automation|автоматизация|,O:tq'meIS(q)n
automobile|автомобиль|'O:tqmqubi:l
autonomy|автономия|O:'tOnqmI
avert|предотвращать|q'vq:t
await|ждать|q'weIt
awkward|неуклюжий|'O:kwqd
backer|сторонник|'bxkq
backlog|невыполненные заказы|'bxklOg
backstreet|глухая улица|
bacon|бекон|'beIkqn
badge|значок, символ|bxdZ
bag|мешок, сумка|bxg
bail|поручительство|beIl
baker|пекарь, булочник|'beIkq
bakery|пекарня|'beIkqrI
balanced|уравновешенный|'bxlqnst
balcony|балкон|'bxlkqnI
ballistic|баллистический|bq'lIstIk
banish|высылать|'bxnIS
banquet|банкет|'bxNkwIt
barber|парикмахер|'bQ:bq
bare|обнаженный|bFq
barely|только, едва|'bFqlI
barley|ячмень|'bQ:lI
barn|амбар|bQ:n
baroness|баронесса|'bxrqnIs
barrack|барак, казарма|'bxrqk
barrage|заграждение|'bxrQ:Z
barricade|баррикада|,bxrI'keId
barrier|барьер|'bxrIq
barrister|адвокат|'bxrIstq
base|низкий, нижний|beIs
baseman|бейсмен|
basement|основание|'beIsmqnt
bat|летучая мышь|bxt
bath|купание|bQ:T
batsman|игрок с битой|'bxtsmqn
batter|сильно бить|'bxtq
bazaar|базар|bq'zQ:
beach|берег, пляж|bi:tS
beam|святить|bi:m
bear|медведь|bFq
beard|борода|bIqd
bearded|бородатый|'bIqdId
beat|удар, бить|bi:t
beaten|битый|'bi:tn
beating|поражение|'bi:tIN
beautifully|красиво, прекрасно|
bedside|постель|
bee|пчела|bi:
beef|говядина|bi:f
beekeeper|пчеловод|
beer|пиво|bIq
beginner|новичок|bI'gInq
behave|вести себя|bI'heIv
being|существование|'bi:IN
bell|колокол, звонок|bel
beneath|ниже, под|bI'ni:T
beneficiary|священник|,benI'fISqrI
benefit|выгода, приносить пользу|'benIfIt
berry|ягода|'berI
beset|окружать|bI'set
best-seller|бестселлер|
betray|предавать|bI'treI
betrayal|предательство|bI'treIql
bias|уклон, наклон, склонять|'baIqs
bidder|выступающий на торгах|'bIdq
bidding|понижение цены|'bIdIN
bike|велосипед|baIk
bill|объявлять в афишах|bIl
bird|птица|bq:d
birdie|птичка|'bq:dI
bit|обуздать|bIt
bite|кусать|baIt
black|черный, ужасный, злой|blxk
black-out|затемнение|
blame|порицание, порицать|bleIm
blank|пустой, чистый|blxNk
blatant|крикливый|'bleItqnt
blaze|гореть ярким пламенем|bleIz
bleak|унылый, мрачный|bli:k
blind|слепой|blaInd
blockade|блокада|blO'keId
blonde|блондин|blOnd
blood|кровь|blAd
bloody|кровавый|'blAdI
blow|дуть, удар, порыв ветра|blqu
blue|синий, голубой|blu:
blueprint|синька|'blu:prInt
blunt|притуплять|blAnt
board|столоваться|bO:d
boast|хвастовство, хвастать|bqust
bodyguard|личная охрана|'bOdIgQ:d
boil|кипятить|bOIl
bolt|молния|bqult
bombardment|бомбардировка|bOm'bQ:dmqnt
bomber|бомбардировщик|'bOmq
bombing|бомбардировка|'bOmIN
bond|обязательство|bOnd
bone|кость|bqun
book-shop|книжный магазин|
booking|продажа билетов|
boom|бум, шумиха, быстро расти|bu:m
boost|повышение, повышать|bu:st
boot|ботинок|bu:t
booth|киоск, палатка|bu:D
border|граница, край, граничить|'bO:dq
bore|сверлить|bO:
born|прирожденный|bO:n
borrow|заимствовать|'bOrqu
bother|надоедать|'bODq
bottle|бутылка|'bOtl
boulevard|бульвар|'bu:lvQ:
bounce|отскакивать|bauns
bound|несвободный|baund
boundary|граница|'baundqrI
bourgeois|буржуазный|bq:'dZOIs
bow|поклон|bau
bowl|резервуар|bqul
bowler|игрок в шары|'bqulq
boxing|бокс|'bOksIN
boycott|бойкот, бойкотировать|'bOIkqt
brain|мозг|breIn
brass|латунь|brQ:s
brave|храбрый, бравировать, храбро встречать|breIv
bravely|смело|
brawl|скандалить|brO:l
breach|брешь, пробивать брешь|bri:tS
breadth|ширина, полотнище|bredT
break-up|развал, распад|'breIk'Ap
breakfast|завтрак|'brekfqst
breed|порождать|bri:d
breeder|производитель|'bri:dq
breeding|разведение|'bri:dIN
brewery|пивоваренный завод|'bruqrI
bribery|взяточничество|'braIbqrI
brick|кирпич|brIk
bride|невеста|braId
brides-maid|подружка невесты|
bridge|мост, соединять мостом|brIdZ
briefly|кратко, сжато|'bri:flI
brigade|бригада|brI'geId
brighten|очищать|'braItn
brilliance|яркость|'brIljqns
brilliant|блестящий|'brIljqnt
broadcast|вещание, передавать по радио|'brO:dkQ:st
broadly|широко|'brO:dlI
brokerage|маклерство|'brqukqrIdZ
bronze|бронза|brOnz
brown|коричневый|braun
brutality|жестокость|bru:'txlItI
brutally|грубо, жестоко|
buccaneer|пират|,bAkq'nIq
budge|шевелиться|bAdZ
bug|устанавливать потайные микрофоны|bAg
bulk|масса, объем|bAlk
bull|бык|bul
bullet|пуля|'bulIt
bullfight|бой быков|'bulfaIt
bullock|вол|'bulqk
bum|бездельник, бродяга|bAm
bunker|бункер|'bANkq
bureaucracy|бюрократия|bjuq'rOkrqsI
burglary|ночная кража со взломом|'bq:glqrI
burial|похороны|'berIql
burst|взрыв|bq:st
bush|куст|buS
butcher|мясник|'butSq
butter|масло|'bAtq
button|пуговица|'bAtn
cabin|кабина|'kxbIn
cadet|курсант военного училища|kq'det
calling|призвание|'kO:lIN
calm|спокойный|kQ:m
cameraman|фоторепортер|
campaigner|участник кампании|kxm'peInq
camper|уголь с примесью|'kxmpq
campus|территория университета|'kxmpqs
can|банка, жестянка|kxn
cancel|аннулировать|'kxnsql
cancellation|аннулирование|,kxnsq'leISqn
cancer|рак|'kxnsq
candid|искренний|'kxndId
cane|тростник, бить палкой|keIn
canister|канистра|'kxnIstq
cannon|пушка, орудие|'kxnqn
canteen|столовая|kxn'ti:n
canvas|холст|'kxnvqs
canyon|каньон|'kxnjqn
cap|шапка|'kxp
cape|мыс|keIp
capsule|оболочка|'kxpsju:l
captain (Capt.)|капитан|
caravan|фургон|'kxrqvxn
card|карта|kQ:d
cardinal|кардинал|'kQ:dInl
careful|заботливый|'kFqful
cargo|груз|'kQ:gqu
carpenter|плотник|'kQ:pIntq
carrying|перевозка|
cartel|картель|kQ:'tel
carve|вырезать|kQ:v
cash|наличные  деньги, касса|kxS
cast|бросать|kQ:st
category|категория|'kxtIgqrI
cater|поставлять провизию|'keItq
cathedral|собор|kq'Ti:drql
cattle|крупный рогатый скот|'kxtl
caution|осторожность|'kO:Sqn
cautions|осторожный|
censorship|цензура|'sensqSIp
censure|осуждение|'senSq
central|телефонная станция|'sentrql
centralism|централизм|
centralize|централизовать|'sentrqlaIz
cereal|хлебный злак|'sIqrIql
cessation|прекращение|se'seISqn
chair|стул|tSFq
chaired|избранный председателем|
chairmanship|обязанности председателя|'tSFqmqnSIp
champagne|шампанское|Sxm'peIn
channel|канал|'tSxnl
charade|шарада|Sq'rQ:d
charitable|благотворительный, милосердный|'tSxrItqbl
charity|милосердие, благотворительность|'tSxrItI
charm|обаяние, прелесть, очаровывать|tSQ:m
chase|погоня, охота|tSeIs
cheaply|дешево, легко|'tSi:plI
check|останавливать, препятствовать|tSek
cheek|щека|tSi:k
cheer|приветствовать громкими возгласами|tSIq
cheerful|бодрый, веселый|'tSIqful
chemicals|химикалии|'kemIkqls
chemist|химик, аптекарь|'kemIst
chemistry|химия|'kemIstrI
cheque|банковский чек|tSek
chess|шахматы|tSes
chest|ящик, грудь|tSest
chestnut|каштан|'tSesnAt
chick|птенец|tSIk
chicken|птенец, цыпленок|'tSIkIn
chiefly|главным образом|'tSi:flI
chill|холод, простуда|tSIl
chine|ущелье, горная гряда|tSaIn
chip|обломок, осколок|tSIp
chocolate|шоколад|'tSOkqlIt
choice|выбор, альтернатива|tSOIs
choose|выбирать, отбирать|tSu:z
cigarette|сигарета|,sIgq'ret
cinema|кино|'sInqmq
circular|круглый, циркулярный|'sq:kjulq
circumstantial|обстоятельный, случайный|,sq:kqm'stxnSql
circus|цирк|'sq:kqs
citation|ссылка, цитирование|saI'teISqn
cite|ссылаться, цитировать|saIt
civic|гражданский|'sIvIk
civilian|гражданский, штатский|sI'vIljqn
clamp|тяжелая поступь|klxmp
clarify|прояснять|'klxrIfaI
clash|столкновение, сталкиваться|klxS
class|класс, классовый|klQ:s
classic|классический|'klxsIk
classify|классифицировать|'klxsIfaI
classroom|класс|'klQ:srum
clause|предложение, статья|klO:z
clean|чистый, чистить, очищать|kli:n
clerical|канцелярский|'klerIkql
clever|умный, ловкий|'klevq
client|клиент|'klaIqnt
climate|климат, атмосфера|'klaImIt
climb|подниматься|klaIm
clinical|клинический|'klInIkql
clip|зажимать, сжимать|klIp
clique|клика|kli:k
clock|часы|klOk
cloister|монастырь|'klOIstq
closing|заключительный|'klquzIN
cloud|облако, туча|klaud
clue|ключ к разгадке|klu:
clutch|захват|klAtS
co-operate|сотрудничать, взаимодействовать|kqu'OpqreIt
co-ordinate|координировать, согласовывать|kqu'O:dIneIt
co-pilot|второй пилот|'kqu'paIlqt
coal-field|каменноугольный бассейн|
coexistence|сосуществование|'kquIg'zIstqns
coincide|совпадать, соответствовать|,kquIn'saId
coincidence|совпадение|kqu'InsIdqns
cold|холод, простуда|kquld
collaborate|сотрудничать|kq'lxbqreIt
collaboration|сотрудничество|kq,lxbq'reISqn
collapse|крушение, крах, рушиться, потерпеть крах|kq'lxps
collar|воротник, ожерелье|'kOlq
collective|коллектив, коллективный|kO'lektIv
collector|коллекционер, сборщик|kq'lektq
collide|сталкиваться|kq'laId
colliery|каменноугольная копь|'kOljqrI
colonel (Col.)|полковник|
colony|колония, поселение|'kOlqnI
colourful|красочный|'kAlqful
combine|синдикат, объединение, объединять|'kOmbaIn
comedian|комик, комедийный актер|kq'mi:djqn
comedy|комедия|'kOmIdI
comic|комический|'kOmIk
commando|десантно-диверсионный отряд|kq'mQ:ndqu
commentator|комментатор|'kOmenteItq
commerce|торговля, коммерция|'kOmq(:)s
commercially|с коммерческой точки зрения|
commission|назначать на должность|kq'mISqn
commodity|товар, продукт|kq'mOdItI
commonly|обыкновенно, дешево, плохо|'kOmqnlI
communicate|сообщать, общаться|kq'mju:nIkeIt
commuter|коллектор, коммутатор|kq'mju:tq
companion|компаньон|kqm'pxnjqn
company (Co.)|фирма|
comparable|сравнимый|'kOmpqrqbl
comparative|сравнительный, относительный|kqm'pxrqtIv
compensate|компенсировать|'kOmpenseIt
compete|состязаться, конкурировать|kqm'pi:t
competitor|соперник, конкурент|kqm'petItq
complacency|благодушие, удовлетворенность|kqm'pleIsnAsI
complementary|дополнительный|,kOmplI'mentqrI
completion|завершение, окончание|kqm'pli:Sqn
complex|комплекс, сложный, составной|'kOmpleks
complicate|осложнять|'kOmplIkeIt
complication|сложность|,kOmplI'keISqn
complicity|соучастие|kqm'plIsItI
compliment|комплимент, похвала|'kOmplIment
complimentary|поздравительный, лестный|,kOmplI'mentqrI
comply|уступать, соглашаться|kqm'plaI
compose|сочинять, составлять|kqm'pquz
composite|составной, сложный|'kOmpqzIt
composition|сочинение, композиция|,kOmpq'zISqn
compound|составной|'kOmpaund
comprise|заключать в себе|kqm'praIz
compromise|компромисс|'kOmprqmaIz
compulsory|принудительный|kqm'pAlsqrI
computer|электронно-вычислительная машина|kqm'pju:tq
comrade|товарищ, компаньон|'kOmrId
con|направлять мысль|kOn
conceal|скрывать, утаивать|kqn'si:l
concede|уступать, допускать|kqn'si:d
conceivably|предположительно|kqn'si:vqblI
conceive|постигать, понимать|kqn'si:v
concerted|согласованный|kqn'sq:tId
concerto|концерт|kqn'tSq:tqu
concession|концессия|kqn'seSqn
conclusive|заключительный|kqn'klu:sIv
concord|согласие, соглашение|'kONkO:d
concrete|бетонировать, сгущать, конкретный|'kOnkri:t
condone|прощать, забывать|kqn'dqun
confer|сопоставлять, предоставлять|kqn'fq:
conferee|участник переговоров|,kOnfq'ri:
confess|признавать|kqn'fes
confine|ограничивать, держать в заключении|kqn'faIn
confirm|подтверждать, утверждать|kqn'fq:m
conflict|конфликт, противоречить|'kOnflIkt
confront|стоять против|kqn'frAnt
confuse|смущать, приводить в замешательство|kqn'fju:z
congratulate|поздравлять|kqn'grxtjuleIt
congregation|собрание, сходка, конгрегация|,kONgrI'geISqn
congressman|член конгресса|'kONgresmqn
conjure|показывать фокусы|'kAndZq
conquer|завоевывать, покорять|'kONkq
conscience|совесть, сознание|'kOnSqns
conscious|сознающий, сознание|-'kOnSqs
consecutive|последующий, последовательный|kqn'sekjutIv
consensus|согласие, единодушие|kqn'sensqs
consent|согласие, разрешение|kqn'sent
consequently|следовательно, в результате|'kOnsIkwqntlI
consistent|совместимый, согласующийся|kqn'sIstqnt
consistently|сообразно, согласно|
consolation|утешение|,kOnsq'leISqn
consolidation|объединение, консолидация|kqn,sOlI'deISqn
consortium|консорциум|kqn'sO:tjqm
constable|констебль, полицейский|'kAnstqbl
constabulary|полиция|kqn'stxbjulqrI
constant|постоянный|'kOnstqnt
constitute|назначать, учреждать|'kOnstItju:t
construct|строить, конструировать|kqn'strAkt
constructive|строительный, конструктивный|kqn'strAktIv
consultative|совещательный, консультативный|kqn'sAltqtIv
container|сосуд, контейнер|kqn'teInq
containment|сдерживание|
contemporary|современный|kqn'tempqrqrI
contempt|презрение, оскорбление|kqn'tempt
contend|бороться, соперничать|kqn'tend
contender|соперник, претендент|kqn'tendq
contest|спор, соревнование|'kOntest
contestant|противник, соперник|kqn'testqnt
continent|материк, континент|'kOntInqnt
continually|непрерывно|
continuation|продолжение|kqn,tInju'eISqn
contract|контракт, заключать контракт|'kOntrxkt
contractor|подрядчик, контрагент|kqn'trxktq
contradiction|противоречие, несоответствие|,kOntrq'dIkSqn
contributory|сотрудничающий, способствующий|kqn'trIbjutqrI
controller|контролер, ревизор|kqn'trqulq
convene|созывать, собирать|kqn'vi:n
convenient|удобный, подходящий|kqn'vi:njqnt
conveyor|транспортер, конвейер|
convinced|убежденный|kqn'vInst
cook|повар, кухарка, готовить пищу|kuk
cooking|стряпня|'kukIN
cookout|приготовление пищи на открытом воздухе|
cool|прохладный, охлаждать|ku:l
cooling|охлаждение|'ku:lIN
coolness|прохлада, хладнокровие|'ku:lnIs
cope|справиться, совладать|kqup
copper|медь|'kOpq
cordon|кордон, охранение|'kO:dn
core|сердцевина, ядро|kO:
corn|зерно, зерновые|kO:n
corporal|телесный|'kO:pqrql
corporation (corp.)|корпорация|
corps|корпус|kO:
correct|исправлять, поправлять|kq'rekt
correctly|правильно, верно|kq'rektlI
corresponding|соответственный, соответствующий|,kOrIs'pOndIN
corruption|разложение, коррупция|kq'rApSqn
cosmetic|косметический|kOz'metIk
cotton|хлопок, бумажная ткань|'kOtn
count|счет, подсчет, внимание|kaunt
counter|прилавок, противостоять, противиться|'kauntq-
counter-charge|встречное обвинение|
countless|бесчисленный|'kauntlIs
coupon|купон, отрывной талон|'ku:pOn
courage|мужество, храбрость|'kArIdZ
courageous|смелый, отважный|kq'reIdZqs
cousin|двоюродный брат|'kAzn
cove|сооружать|kquv
cow|корова|kau
crack|треск, трещина|krxk
craftsman|ремесленник|'krQ:ftsmqn
crash|крах, крушение|krxS
crave|жаждать, просить, умолять|kreIv
crazy|безумный|'kreIzI
cream|сливки, крем|kri:m
cricket|крикет|'krIkIt
criminal|преступник, уголовный|'krImInl
cripple|калечить, уродовать|'krIpl
crisp|хрустящий картофель|krIsp
critic|критик, критикан|'krItIk
crook|крюк, крючок, поворот|kruk
cross-examination|перекрестный допрос|'krOsIg,zxmI'neISqn
crowd|толпиться, толпа|kraud
crucial|решающий, критический|'kru:Sql
crude|сырой, необработанный|kru:d
cruel|жестокий, безжалостный|kruql
cruise|морское путешествие|kru:z
crusade|крестовый поход|kru:'seId
crush|раздавливание, дробление|krAS
crust|корка, кора|krAst
cry|кричать, плакать|kraI
crystal|кристалл, хрусталь|'krIstl
cub|детеныш|kAb
cube|куб|kju:b
cuff|удар|kAf
culminate|достигать вершины|'kAlmIneIt
curfew|комендантский час|'kq:fju:
curiosity|любознательность, любопытство|,kjuqrI'OsItI
curious|любознательный, пытливый|'kjuqrIqs
current|течение, ход|'kArqnt
curriculum|расписание|kq'rIkjulqm
curtain|занавеска, завеса|'kq:tn
custody|опека, заключение|'kAstqdI
custom|обычай, привычка|'kAstqm
cutting|резание, сокращение|'kAtIN
cycle|цикл, период|'saIkl
cynical|циничный, бесстыдный|'sInIkql
dairy|маслодельня, молочная|'dFqrI
damp|сырость, влажность|dxmp
dance|танцевать, заставлять танцевать|dQ:ns
dancer|танцор, танцовщик, танец|'dQ:nsq
dare|сметь, отважиться|dFq
dark|темный, неясный|dQ:k
data|данные, факты|'deItq
dawn|рассвет, начало|dO:n
daylight|дневной свет|'deIlaIt
deadline|запретная черта|
deadlock|тупик, безвыходное положение|'dedlOk
deadly|смертельно|'dedlI
deaf|глухой|def
dear|дорогой, милый, любимый|dIq
debris|обломки, развалины|'deIbri:
debut|дебют|'deIbu:
decay|гниение, разложение|dI'keI
decent|приличный, благопристойный|'di:snt
decisive|решительный|dI'saIsIv
deck|палуба|dek
declaration|заявление, объявление|,deklq'reISqn
decline|падение, спад|dI'klaIn
decoration|украшение, знак отличия|,dekq'reISqn
decrease|уменьшение, понижение, уменьшать|'di:kri:s
decree|декрет, постановление|dI'kri:
deer|олень|dIq
defender|защитник, чемпион|dI'fendq
defensive|оборонительный|dI'fensIv
defiant|вызывающий, дерзкий|dI'faIqnt
deficiency|недостаток, дефицит|dI'fISqnsI
definite|определенный, точный|'defInIt
definitely|определенно, точно|'defInqtlI
deformed|искаженный|
deliberate|умышленный, обдуманный|dI'lIbqreIt
deliberately|умышленно, обдуманно|dI'lIbqrItlI
delicate|утонченный, хрупкий|'delIkIt
delight|восторг, восхищаться, наслаждаться|dI'laIt
delinquent|правонарушитель|dI'lINkwqnt
delta|дельта|'deltq
democratically|демократически|,demq'krxtIk(q)lI
demolish|уничтожать, опровергать|dI'mOlIS
demolition|уничтожение|,demq'lISqn
denial|отрицание, опровержение|dI'naIql
department (Dept.)|отдел, департамент|
departure|отъезд, уход|dI'pQ:tSq
dependence|зависимость|dI'pendqns
dependent|зависимый, зависящий|dI'pendqnt
depict|рисовать, изображать|dI'pIkt
deplore|сожалеть|dI'plO:
deploy|развертывать|dI'plOI
deployment|развертывание|dI'plOImqnt
deport|высылать, депортировать|dI'pO:t
deportation|высылка, депортация|,di:pO:'teISqn
deposit|вклад, взнос|dI'pOzIt
depot|склад, депо|'depqu
depreciation|обесценивание, пренебрежение|dI,pri:SI'eISqn
depress|подавлять, уничтожать|dI'pres
depression|депрессия|dI'preSqn
deprive|лишать, отбирать|dI'praIv
depth|глубина|depT
deputation|делегация, депутация|,depju(:)'teISqn
derive|производить|dI'raIv
description|описание, вид, род|dIs'krIpSqn
desert|пустыня|dI'zq:t
deserve|заслуживать|dI'zq:v
designate|чертить, проектировать|'dezIgneIt
designed|предназначенный, намеренный|dI'zaInd
designer|проектировщик, дизайнер|dI'zaInq
desire|желать, желание, мечта|dI'zaIq
despair|отчаяние|dIs'pFq
desperate|отчаянный, безнадежный|'despqrIt
desperately|отчаянно, безнадежно|
destination|место назначения|,destI'neISqn
destiny|судьба, участь|'destInI
destruction|разрушение, уничтожение|dIs'trAkSqn
detain|задерживать, удерживать|dI'teIn
detect|открывать, обнаруживать|dI'tekt
detection|открытие, обнаружение|dI'tekSqn
detective|детектив|dI'tektIv
detente|разрядка|de'tQ:Nt
detention|задержание|dI'tenSqn
determined|решительный|dI'tq:mInd
deterrent|сдерживающий|dI'terqnt
detrimental|приносящий ущерб|,detrI'mentl
devastate|опустошать|'devqsteIt
devil|дьявол|'devl
devise|разрабатывать|dI'vaIz
devolution|передача|,di:vq'lu:Sqn
diameter|диаметр|daI'xmItq
dictatorship|диктатура|dIk'teItqSIp
diesel|дизель|'di:zql
differ|отличаться|'dIfq
differential|отличительный, разница в оплате труда|,dIfq'renSql
dig|копать|dIg
dignity|достоинство|'dIgnItI
dimension|измерение|dI'menSqn
diminish|уменьшать|dI'mInIS
diminutive|маленький|dI'mInjutIv
dine|обедать|daIn
dip|погружать|dIp
diplomat|дипломат|'dIplqmxt
diplomatically|дипломатически|
dirty|грязный|'dq:tI
disable|делать непригодным|dIs'eIbl
disadvantage|недостаток|,dIsqd'vQ:ntIdZ
disagree|не согласовываться|,dIsq'gri:
disagreement|расхождение|,dIsq'gri:mqnt
disappoint|разочаровывать|,dIsq'pOInt
disapproval|неодобрение|,dIsq'pru:vql
disastrous|бедственный|dI'zQ:strqs
discard|отбрасывать|'dIskQ:d
discharge|разряжать|dIs'tSQ:dZ
disciplinary|дисциплинарный|'dIsIplInqrI
disciplined|дисциплинированный|
disclosure|раскрытие|dIs'klquZq
discount|скидка, дисконтировать|'dIskaunt
discourage|обескураживать|dIs'kArIdZ
discovery|открытие|dIs'kAvqrI
discredit|дискредитировать|dIs'kredIt
disease|болезнь|dI'zi:z
disgraceful|позорный|dIs'greIsful
disillusion|разочаровывать|,dIsI'lu:Zqn
disillusionment|разочарование|
dislike|испытывать неприязнь|dIs'laIk
dispatch|отправлять|dIs'pxtS
dispel|рассеивать|dIs'pel
disperse|рассеиваться|dIs'pq:s
display|демонстрация, показывать|dIs'pleI
dispose|располагать|dIs'pquz
disquiet|беспокоить|dIs'kwaIqt
disrupt|подрывать|dIs'rApt
dissatisfaction|неудовлетворительность|'dIs'sxtIs'fxkSqn
dissent|разногласие|dI'sent
dissident|диссидент|'dIsIdqnt
dissociate|разъединять|dI'squSIeIt
dissolve|распускать|dI'zOlv
distinct|ясный|dIs'tINkt
distinction|различие|dIs'tINkSqn
distinctly|отчетливо|dIs'tINktlI
distort|искажать|dIs'tO:t
distortion|искажение|dIs'tO:Sqn
distributive|распределительный|dIs'trIbjutIv
disturbance|нарушение|dIs'tq:bqns
ditch|канава, траншея|dItS
dive|нырять|daIv
divert|отклонять|daI'vq:t
divided|разделенный на части|dI'vaIdId
divorce|разводить|dI,vO:'si:
dock|док|dOk
docker|докер|'dOkq
dockyard|судоремонтный завод|'dOkjQ:d
doctrine|доктрина|'dOktrIn
documentary|документальный|,dOkju'mentqrI
dodge|уловка, хитрость|dOdZ
doll|кукла|dOl
dominant|доминирующий|'dOmInqnt
domination|господство|dOmI'neISqn
donation|денежное пожертвование|dqu'neISn
doom|обрекать|du:m
dope|наркотик|
dosage|дозировка|
dose|доза, дозировать|dqus
double|двойное количество, двойной|'dAbl
doubtful|сомневающийся|'dautfl
downward|вниз, книзу|'daunwqd
drab|тускло-коричневый цвет|drxb
drag|тащить|drxg
drain|вытекание|dreIn
drastic|решительный|'drxstIk
drastically|решительно|
dreadful|ужасный|'dredful
dream|сон, мечта, видеть сны|dri:m
dressed|одетый|
drill|тренировать|drIl
drink|напиток, пить|drINk
drinking|питье|
drive|езда, гонка|draIv
driving|езда, вождение, движущий|'draIvIN
dropping|сбрасывающий|
dry|сушить, сухой|draI
duck|утка, парусина|dAk
dull|тупой, вялый|dAl
duly|должным образом|
duration|продолжительность|dju'reISn
dye|красить|daI
dynamic|динамический|daI'nxmIk
eagle|орел|'i:gl
ear|ухо|Iq
earnest|серьезный|'q:nIst
earthquake|землетрясение|'q:TkweIk
echo|вторить, подражать|'ekqu
economically|экономно|,i:kq'nOmIkqlI
economist|экономист|I(:)'kOnqmIst
ecumenical|экуменический|,i:kju(:)'menIkql
edge|острие, заострять|edZ
edition|издание|I'dISqn
educate|воспитывать|'edju(:)keIt
effectively|эффективно|
effectiveness|эффективность|
efficiency|эффективность|I'fISqnsI
efficient|эффективный|I'fISqnt
ego|субъект, эго|'egqu
eject|изгонять|I(:)'dZekt
elderly|пожилой|'eldqlI
electioneering|предвыборная кампания|
electoral|избирательный|I'lektqrql
electorate|избиратели|I'lektqrIt
electrician|электрик|Ilek'trISqn
electronic|электронный|Ilek'trOnIk
elementary|элементарный|,elI'mentqrI
elephant|слон|'elIfqnt
eligible|подходящий|'elIdZqbl
elimination|исключение|I,lImI'neISqn
elite|элита|eI'li:t
eloquent|красноречивый|'elqukwqnt
emancipation|освобождение|I,mxnsI'peISqn
embargo|эмбарго|em'bQ:gqu
emotion|возбуждение|I'mquSqn
emotional|эмоциональный|I'mquSqnl
empower|уполномочивать|Im'pauq
enact|предписывать|I'nxkt
enclose|окружать|In'klquz
encouragement|удобрение|In'kArIdZmqnt
encyclical|энциклика|en'sIklIkql
endanger|подвергать опасности|In'deIndZq
endeavour|попытка|In'devq
endless|бесконечный|'endlIs
endlessly|нескончаемо|
endorse|подписываться|In'dO:s
endorsement|подтверждение|In'dO:smqnt
enforcement|принуждение|In'fO:smqnt
engagement|занятие|In'geIdZmqnt
enjoy|наслаждаться|In'dZOI
enormously|чрезвычайно|I'nO:mqslI
enrich|обогащать|In'rItS
entering|вступление|
enthusiast|энтузиаст|In'Tju:zIxst
entrance|вход, вступление|In'trQ:ns
envelope|конверт|'envqlqup
envisage|смотреть в лицо|In'vIzIdZ
equal|равняться|'i:kwql
equivalent|эквивалент, эквивалентный|I'kwIvqlqnt
erect|строить|I'rekt
erosion|эрозия|I'rquZqn
error|ошибка|'erq
escort|охрана|'eskO:t
espionage|шпионаж|,espIq'nQ:Z
essence|сущность|'esns
essentially|по существу|I'senSqlI
established|установленный|Is'txblISt
estimated|предполагаемый|
etcetera (etc)|и т.д.|
eternal|вечный|I(:)'tq:nl
ethics|этика|'eTIks
ethnic|этнический|'eTnIk
evacuate|эвакуировать|I'vxkjueIt
evaluation|оценка|I,vxlju'eISqn
evasion|увертка|I'veIZqn
eve|канун|i:v
eventual|возможный|I'ventSuql
evict|выселять|I(:)'vIkt
evident|очевидный|'evIdqnt
evil|дурной, злой|'i:vl
evolve|развивать|I'vOlv
exact|точный|Ig'zxkt
except|исключать, исключая, кроме|Ik'sept
exceptional|исключительный|Ik'sepSqnl
exceptionally|исключительно|Ik'sepSqnlI
excess|избыток|Ik'ses
exchequer|казначейство|Iks'tSekq
excitement|возбуждение|Ik'saItmqnt
exclusively|исключительно|Iks'klu:sIvlI
excuse|извинение, извинять|Iks'kju:s
execute|выполнять|'eksIkju:t
execution|выполнение|,eksI'kju:Sqn
exempt|освобожденный|Ig'zempt
exert|осуществлять|Ig'zq:t
exhaust|истощать|Ig'zO:st
exhaustion|истощение|Ig'zO:stSqn
exhibit|экспонат,  показывать|Ig'zIbIt
exile|ссылка, изгонять|'eksaIl
expectation|ожидание|,ekspek'teISqn
expedition|экспедиция|,ekspI'dISqn
experimental|экспериментальный|eks,perI'mentl
expire|кончаться|Iks'paIq
explicit|ясный|Iks'plIsIt
exploit|эксплуатировать|'eksplOIt
exploitation|эксплуатация|,eksplOI'teISqn
exploration|исследование|,eksplO:'reISqn
explore|исследовать|Iks'plO:
explosive|взрывчатое вещество, взрывчатый, вспыльчивый|Iks'plqusIv
exporter|экспортер|eks'pO:tq
express|определенный|Iks'pres
expression|выражение|Iks'preSqn
expulsion|изгнание|Iks'pAlSqn
exquisite|изысканный|'ekskwIzIt
extended|растянутый|Iks'tendId
extensive|обширный|Iks'tensIv
external|наружный|eks'tq:nl
extract|выписка|'ekstrxkt
extremely|крайне|Iks'tri:mlI
extremist|экстремист|Iks'tri:mIst
fabric|ткань|'fxbrIk
fabulous|баснословный|'fxbjulqs
facilitate|облегчать|fq'sIlIteIt
facing|облицовка|'feIsIN
faction|фракция|'fxkSqn
fad|прихоть|fxd
fail|неудача, терпеть неудачу, подводить|feIl
fairy|сказочный|'fFqrI
falling|падение|'fO:lIN
fallout|осадки|
fancy|причудливый|'fxnsI
fantastic|фантастический|fxn'txstIk
fantasy|воображение|'fxntqsI
farce|фарс|fQ:s
fare|плата за проезд|fFq
farm|ферма, заниматься сельским хозяйством|fQ:m
farmworker|сельскохозяйственный рабочий|
fascinate|очаровывать|'fxsIneIt
fast|быстро, быстрый, острый|fQ:st
fatal|фатальный|'feItl
fate|судьба|feIt
favourite|любимый|'feIvqrIt
feasibility|осуществимость|
feasible|осуществимый|'fi:zqbl
federate|объединяться на федеративных началах|'fedqreIt
fee|гонорар, чаевые, платить гонорар|fi:
feeding|питание|
female|особь женского пола|'fi:meIl
feminist|феминист|'femInIst
fence|забор|fens
ferocious|дикий|fq'rquSqs
ferry|перевоз|'ferI
fertilizer|удобрение|'fq:tIlaIzq
feud|вражда|fju:d
fiction|вымысел|'fIkSqn
fierce|свирепый|fIqs
fifteen|пятнадцать|'fIf'ti:n
fighter|боец, борец|'faItq
file|регистрировать и хранить|faIl
filling|наполнение|'fIlIN
filly|молодая кобыла|'fIlI
finalist|участник финала|
finalize|завершать|'faInqlaIz
financially|в финансовом отношении|
fine|штраф|faIn
fingerprint|отпечаток пальца|'fINgqprInt
finishing|завершение|'fInISIN
fireman|пожарный|'faIqmqn
firework|фейерверк|'faIqwq:k
firm|укреплять|fq:m
firmness|твердость|
fisherman|рыбак|'fISqmqn
fist|кулак|fIst
fit|подгонка|fIt
fitness|годность|'fItnIs
flagrant|ужасающий|'fleIgrqnt
flare|ярко вспыхивать|flFq
flat|плоско, ровно|flxt
flee|бежать|fli:
fling|летать|flIN
float|плавать|flqut
flock|пушинка|flOk
flood|наводнение|flAd
flowing|течение|'flquIN
flurry|будоражить|'flArI
fly|муха, прыжок|flaI
flying|летучий|'flaIIN
focus|фокусировать|'fqukqs
fog|туман|fOg
folk|люди|fquk
folly|глупость|'fOlI
fond|любящий|fOnd
forbid|запрещать|fq'bId
fore|передний|fO:
forecast|предсказывать|'fO:kQ:st
forecasting|предсказание|
foreigner|иностранец|'fOrInq
foremost|передовой|'fO:mqust
foresee|предвидеть|fO:'si:
forge|выдумывать|fO:dZ
formally|формально|
former|создатель|'fO:mq
formidable|внушительный|'fO:mIdqbl
formula|формула|'fO:mjulq
fort|форт|fO:t
forthcome|приближаться|
forthwith|тотчас, немедленно|'fO:T'wIT
fortunately|к счастью|
fortune|удача|'fO:tSqn
foster|воспитывать|'fOstq
found|основывать|faund
founder|основатель|'faundq
foundry|литейный цех|'faundrI
fourth|четвертый|fO:T
fractional|дробный|'frxkSqnl
fragment|обломок|'frxgmqnt
framework|каркас|'freImwq:k
frantic|неистовый|'frxntIk
fraternal|братский|frq'tq:nl
fraud|обман, фальшивка|frO:d
freely|свободно|'fri:lI
freezing|замерзание|'fri:zIN
freight|фрахт|freIt
freighter|фрахтовщик|'freItq
frenzy|безумие|'frenzI
frequent|частый|'fri:kwqnt
friendly|дружеский|'frendlI
frighten|пугать|'fraItn
frontier|граница|'frAntIq
frost|мороз|frOst
fruit|плод, фрукты|fru:t
frustrate|расстраивать|frAs'treIt
frustration|расстройство|frAs'treISqn
fulfil|выполнять|ful'fIl
function|функционировать|'fAnNkSqn
fund|вкладывать капитал в ценные бумаги|fAnd
fundamentally|существенный|
funeral|похороны|'fju:nqrql
furniture|мебель|'fq:nItSq
furthermore|кроме того|'fq:Dq'mO:
fury|неистовство|'fjuqrI
gainer|победитель|
gale|шторм|geIl
gallon|галлон|'gxlqn
gamble|играть в азартные игры|'gxmbl
gaol|заключать в тюрьму|dZeIl
garage|гараж|'gxrQ:Z
gathering|собирание|'gxDqrIN
gay|веселый|geI
gear|механизм|gIq
gelatin|желатин|,dZelq'ti:n
general (Gen.)|генерал|
generate|порождать|'dZenqreIt
genius|гений|'dZi:njqs
gently|мягко, кротко|'dZentlI
genuine|подлинный|'dZenjuIn
geographical|географический|dZIq'grxfIkql
gesture|жест|'dZestSq
ghetto|гетто|'getqu
giant|гигант, гигантский|'dZaIqnt
gift|подарок, дар|gIft
gigantic|гигантский|dZaI'gxntIk
gilt-edged|с золотым обрезом|'gIltedZd
ginger|имбирь|'dZIndZq
giving|присвоение|
glad|довольный|glxd
glamour|обаяние|'glxmq
glare|сверкать|glFq
gloomy|мрачный|'glu:mI
glorious|великолепный|'glO:rIqs
glory|слава|'glO:rI
glove|перчатка|glAv
glow|сильный жар, накаляться|glqu
goalkeeper|вратарь|'gqul,ki:pq
going|отъезд|'gquIN
gold|золото, золотой|gquld
golf|гольф, играть в гольф|gOlf
golfer|игрок в гольф|'gOlfq
goodbye|прощание|'gud'baI
goods|товары|gudz
goodwill|добрая воля|'gud'wIl
gossip|болтовня|'gOsIp
governmental|правительственный|,gAvqn'mentl
grab|внезапно схватывать|grxb
grace|грация, изящество|greIs
grade|сортировать, степень|greId
gradual|постепенно|'grxdjuql
graduated|дипломированный|
graduation|окончание ВУЗа|,grxdju'eISqn
grammar|грамматика|'grxmq
grasp|схватывать|grQ:sp
gratitude|благодарность|'grxtItju:d
grave|могила|greIv
gravel|гравий|'grxvql
gravity|серьезность|'grxvItI
greats|сильные мира сего|greIts
greenery|зелень, растительность|'gri:nqrI
greet|приветствовать|gri:t
grieve|огорчать|gri:v
grievously|горестно|'gri:vqslI
grill|решетка|grIl
grip|схватывание|grIp
groom|чистить лошадь|grum
grotesque|абсурдный|grqu'tesk
group|группировка, группа, группировать|gru:p
grouping|классификация|'gru:pIN
growing|растущий|'grquIN
guarantee|гарантия, гарантировать|,gxrqn'ti:
guard|охрана, охранять|gQ:d
guarded|охраняемый|
guess|догадываться|ges
guide|проводник|gaId
guilt|вина, грех|gIlt
guinea|гинея|'gInI
gulf|залив, бухта|gAlf
gun|орудие, стрелять|gAn
gunman|человек, вооруженный ружьем|'gAnmqn
gut|потрошить|gAt
habit|привычка|'hxbIt
hail|приветствовать|heIl
halfback|полузащитник|
halfway|лежащий на полпути|
halt|остановка, останавливать|hO:lt
hammer|молоток|'hxmq
hamper|препятствие|'hxmpq
handful|горсть|'hxndful
handicap|препятствовать|'hxndIkxp
handout|милостыня|'hxndaut
handsome|красивый|'hxnsqm
hangar|склад|'hxNq
hanging|подвешивание|'hxNIN
happening|случай, событие|'hxpnIN
happily|счастливо|'hxpIlI
harass|беспокоить|'hxrqs
harassment|беспокойство|
harbour|гавань, порт|'hQ:bq
harden|твердеть|'hQ:dn
hardship|лишение|'hQ:dSIp
harm|вред, ущерб|hQ:m
harmful|вредный, пагубный|'hQ:mful
harmony|гармония, согласованность|'hQ:mqnI
harsh|грубый, жестокий|hQ:S
harvest|уборка урожая|'hQ:vIst
hatch|высиживать|hxtS
hate|ненавидеть, ненависть|heIt
haul|тянуть|hO:l
hawker|уличный торговец|'hO:kq
hazard|шанс, опасность|'hxzqd
haze|легкий туман|heIz
he|он|hi:-
headache|головная боль|'hedeIk
headmaster|директор школы|
heal|излечивать|hi:l
healthy|здоровый|'helTI
heaven|небеса, небо|'hevn
heavy|тяжело, вяло|'hevI
hedge|ограда|hedZ
heel|каблук|hi:l
helpful|полезный|'helpful
hence|следовательно|hens
herd|стадо, пастух|hq:d
heroine|героиня|'herquIn
herring|сельдь|'herIN
hesitant|колеблющийся|'hezItqnt
hesitate|колебаться|'hezIteIt
highlight|основной момент, выдвигать на первый план|'haIlaIt
highway|главный путь|'haIweI
hijack|захватывать|'haIdZxk
hillside|склон горы|
hire|наем, прокат, нанимать|'haIq
historical|исторический|hIs'tOrIkql
hit|удар, попадание, ударять|hIt
hitherto|до сих пор|'hIDq'tu:
hive|давать приют|haIv
hoax|разыгрывать|hquks
hockey|хоккей|'hOkI
holding|владение|'hquldIN
hole|продырявливать|hqul
holed|перфорирование|
holidaymaker|отдыхающий|
hollow|пустой, полый|'hOlqu
home|дом, домашний,  домой|hqum
honest|честный|'OnIst
honesty|честность|'OnIstI
honeymoon|медовый месяц|'hAnImu:n
hook|зацепка|huk
horizon|горизонт|hq'raIzn
hormone|гормон|'hO:mqun
horn|рог|hO:n
horrific|ужасающий|hO'rIfIk
horror|ужас|'hOrq
hose|рукав|hquz
hostage|заложник|'hOstIdZ
hostile|неприятельский|'hOstaIl
hot|горячо, жарко|hOt
hot-dog|горячая сосиска|
hound|травить|haund
household|семья|'haushquld
housewife|домашняя хозяйка|'hauswaIf
humanity|человечество|hju(:)'mxnItI
humor|юмор, комизм|'hju:mq
hunger|голод|'hANgq
hungry|голодный|'hANgrI
hurt|причинять боль|hq:t
hysteria|истерия|hIs'tIqrIq
hysterical|истерический|hIs'terIkql
icy|ледяной|'aIsI
ideal|идеал, идеальный|aI'dIql
identification|отождествление|aI,dentIfI'keISqn
identify|отождествлять|aI'dentIfaI
idle|незанятый|'aIdl
ignorance|невежество|'Ignqrqns
ill|плохо, худо, больной|Il
ill-fated|несчастливый|'Il'feItId
illusion|иллюзия|I'lu:Zqn
illustrate|иллюстрировать|'IlqstreIt
image|изображать|'ImIdZ
imagination|воображение|I,mxdZI'neISqn
immense|огромный|I'mens
immensely|чрезвычайный|I'menslI
imminent|надвигающийся|'ImInqnt
immunity|иммунитет|I'mju:nItI
impair|ослаблять|Im'pFq
impatience|нетерпение|Im'peISqns
imperial|императорский|Im'pIqrIql
imperialist|империалист|Im'pIqrIqlIst
implacably|неумолимо|
implant|внедрять, насаждать|'ImplQ:nt
implication|вовлечение|,ImplI'keISqn
implied|подразумеваемый|
import|импорт, импортировать|'ImpO:t
importer|импортер|Im'pO:tq
imposition|наложение|,Impq'zISqn
impotent|бессильный|'Impqtqnt
impression|впечатление|Im'preSqn
imprisonment|тюремное заключение|Im'prIznmqnt
impropriety|неуместность|,Imprq'praIqtI
improved|улучшенный|Im'pru:vd
inadequacy|неадекватность|In'xdIkwqsI
inaugurate|торжественно вводить в должность|I'nO:gjureIt
incentive|стимул|In'sentIv
incidentally|между прочим|,InsI'dentlI
incite|возбуждать|In'saIt
incitement|возбуждение|In'saItmqnt
incline|склонять|In'klaIn
inclusion|включение|In'klu:Zqn
incorporate|объединять|In'kO:pqreIt
incredible|невероятный|In'kredqbl
incumbent|лицо, занимающее должность|In'kAmbqnt
incur|подвергаться|In'kq:
independently|независимо|
indifference|безразличие|In'dIfrqns
indifferent|безразличный|In'dIfrqnt
indigenous|местный|In'dIdZInqs
indirect|косвенный|,IndI'rekt
indiscipline|недисциплинированность|In'dIsIplIn
indoors|в помещении|'In'dO:z
induce|убеждать|In'dju:s
indulge|позволить себе|In'dAldZ
industrialist|промышленник|In'dAstrIqlIst
industrialization|индустриализация|In,dAstrIqlaI'zeISqn
industrialize|осуществлять индустриализацию|
ineffective|неэффективный|,InI'fektIv
inefficient|неспособный|,InI'fISqnt
inevitably|неизбежно|In'evItqblI
inexcusable|непростительный|,InIks'kju:zqbl
inexperienced|неопытный|
infantry|пехота|'InfqntrI
inference|вывод, заключение|'Infqrqns
infiltration|проникновение|,InfIl'treISqn
infinitely|бесконечно|
inflict|наносить|In'flIkt
influence|влияние, оказать влияние|'Influqns
influential|влиятельный|,Influ'enSql
informal|неофициальный|In'fO:ml
informally|неофициально|
informant|информант|In'fO:mqnt
informed|осведомленный|In'fO:md
infringe|нарушать|In'frIndZ
inhabitant|житель|In'hxbItqnt
inherent|присущий|In'hIqrqnt
inhuman|бесчеловечный|In'hju:mqn
initial|начальная буква|I'nISql
initially|вначале|I'nISqlI
initiative|начальный|I'nISIqtIv
injection|инъекция|In'dZekSqn
injured|поврежденный|'IndZqd
injustice|несправедливость|In'dZAstIs
inland|внутренний|'Inlqnd
inn|гостиница|In
inner|внутренний|'Inq
innocence|невинность|'Inqsqns
innocent|невинный|'Inqsqnt
innumerable|бесчисленный|I'nju:mqrqbl
inquire|спрашивать|In'kwaIq
insect|насекомое|'Insekt
inside|внутрь, внутренний|'In'saId
inspect|рассматривать|In'spekt
inspection|осмотр|In'spekSqn
inspiration|вдохновение|,Inspq'reISqn
inspire|внушать|In'spaIq
install|вводить в должность|In'stO:l
installation|введение в должность|,Instq'leISqn
instantly|немедленно|'InstqntlI
instigate|подстрекать|'InstIgeIt
instinct|инстинкт|'InstINkt
instruction|обучение|In'strAkSqn
instructor|инструктор|In'strAktq
insufficient|недостаточный|,Insq'fISqnt
insult|оскорбление|'InsAlt
insure|обеспечивать|In'Suq
intake|поглощение|'InteIk
integral|неотъемлемый|'IntIgrql
integrate|объединять|'IntIgreIt
intellectual|интеллигент|,IntI'lektjuql
intelligent|умный|In'telIdZqnt
intended|предполагаемый|In'tendId
intense|сильный|In'tens
intensify|усиливать|In'tensIfaI
intercontinental|межконтинентальный|'Intq(:),kOntI'nentl
interdependence|взаимозависимость|,Intq(:)dI'pendqns
interdependent|взаимозависимый|,Intq(:)dI'pendqnt
interfere|мешать|,Intq'fIq
interference|вмешательство|,Intq'fIqrqns
interim|предварительный|'IntqrIm
interior|внутренность|In'tIqrIq
intermission|перерыв, пауза|,Intq(:)'mISqn
internally|в международном масштабе|In'tq:nqlI
international|международные соревнования|,Intq(:)'nxSqnl
interpret|интерпретировать|In'tq:prIt
interpretation|интерпретация|In,tq:prI'teISqn
interpreter|интерпретатор|In'tq:prItq
interrupt|прерывать|,Intq'rApt
interruption|прерывание|,Intq'rApSqn
interval|интервал|'Intqvql
intervene|вмешиваться|,Intq(:)'vi:n
interview|интервью, интервьюировать|'Intqvju:
intimate|глубокий, интимный|'IntImeIt
invade|вторгаться|In'veId
invalid|недействительный|,Invq'li:d
invariably|неизменно|In'veqrIqblI
invasion|вторжение|In'veIZqn
invent|изобретать|In'vent
invention|изобретение|In'venSqn
investigator|следовательно|In'vestIgeItq
invoke|призывать|In'vquk
involved|сложный|In'vOlvd
iron|железо, железный, сильный|'aIqn
ironic|иронический|aI'rOnIk
ironically|иронически|aI'rOnIk(q)lI
irony|ирония|'aIqrqnI
irresistible|непреодолимый|,IrI'zIstqbl
irrespective|безотносительный|,IrIs'pektIv
irresponsibility|безответственность|'IrIs,pOnsq'bIlItI
irresponsible|безответственный|,IrIs'pOnsqbl
isolation|изоляция|,aIsqu'leISqn
jade|нефрит|dZeId
jam|сжатие, сжимать|dZxm
jar|дребезжание|dZQ:
jaw|челюсть|dZO:
jeer|насмешка|dZIq
jeopardize|подвергать опасности|'dZepqdaIz
jeopardy|опасность|'dZepqdI
jeweller|ювелир|'dZu:qlq
jewellery|драгоценности|'dZu:qlrI
jewels|драгоценности|
jobless|безработный|'dZOblIs
joining|соединение|
jointly|совместный|'dZOIntlI
joke|шутка, шутить|dZquk
jolly|праздничный|'dZOlI
journey|поездка, рейс|'dZq:nI
jubilee|юбилей|'dZu:bIli:
judicial|судебный|dZu(:)'dISql
judiciary|судопроизводство|dZu(:)'dISIqrI
juicy|сочный, дождливый|'dZu:sI
jump|прыжок, скачок, прыгать|dZAmp
jumper|прыгун|'dZAmpq
junction|соединение|'dZANkSqn
jungle|джунгли|'dZANgl-
junta|хунта|'dZAntq
juror|присяжные заседатели|'dZuqrq
justifiable|законный|'dZAstIfaIqbl
justification|оправдание|,dZAstIfI'keISqn
juvenile|юноша, подросток|'dZu:vInaIl
key|ключ, запирать на ключ|ki:
kick|удар, бить|kIk
kid|ребенок|kId
kidnap|похищать детей|'kIdnxp
killer|убийца|'kIlq
killing|убийственный|'kIlIN
kingdom|королевство|'kINdqm
kirk|церковь|kq:k
kiss|поцелуй|kIs
kitchen|кухня|'kItSIn
kite|бумажный змей|kaIt
kitten|котенок|'kItn
kitty|цель|'kItI
knee|колено|ni:
knife|нож|naIf
knight|рыцарь|naIt
label|этикетка, приклеивать ярлык|'leIbl
labour|труд, трудиться|'leIbq
labourer|рабочий|'leIbqrq
lace|шнурок|leIs
lad|парень|lxd
lamely|неубедительно|
lamp|лампа|lxmp
lampshade|абажур|
land|высаживать|lxnd
landed|земельный|'lxndId
landfall|приземление|'lxndfO:l
landing|высадка на берег|'lxndIN
landlord|домовладелец|'lxnlO:d
landscape|ландшафт, пейзаж|'lxnskeIp
landslide|оползень, обвал|'lxndslaId
lap|подол|lxp
lapse|описка|lxps
large-scale|крупномасштабный|
last|последний|lQ:st
laugh|смех, смеяться|lQ:f
laughter|хохот|'lQ:ftq
launching|спуск|
layoff|приостановка производства|
leaf|лист|li:f
leaflet|листовка|'li:flIt
leak|просачиваться|li:k
leap|прыжок, прыгать|li:p
learned|ученый|'lq:nId
learning|учение|'lq:nIN
leash|свора, привязь|li:S
least|наименьший|li:st
leaver|выпускник|
lecture|лекция|'lektSq
left|налево, слева, левый|left
left-handed|левосторонний|
legalistic|юридический|
legality|законность|lI(:)'gxlItI
legalize|узаконивать|'li:gqlaIz
legally|законно|
legend|легенда|'ledZqnd
leprosy|проказа|'leprqsI
less|меньший|les
lessen|уменьшать|'lesn
lesson|урок|'lesn
lettuce|салат|'letIs
level|спокойный, выравнивать|'levl
lever|рычаг|'li:vq
lexicon|словарь|'leksIkqn
liable|подлежащий|'laIqbl
libel|клевета|'laIbql
liberty|свобода|'lIbqtI
librarian|библиотекарь|laI'brFqrIqn
license|давать разрешение|'laIsqns
lien|залог|lIqn
lieutenant|лейтенант|lef'tenqnt
lieutenant-colonel|подполковник|
lieutenant-general|генерал-лейтенант|lef'tenqnt'dZenqrql
lifetime|продолжительность жизни|'laIftaIm
light|свет|laIt
lighting|освещение|'laItIN
lightweight|легкий вес|
likelihood|вероятность|'laIklIhud
limitation|ограничение|,lImI'teISqn
limited (ltd)|с ограниченной ответственностью|
limiting|ограничивающий|
liquid|жидкость|'lIkwId
liquidation|ликвидация|,lIkwI'deISqn
liquor|напиток|'lIkq
lively|живой, живо|'laIvlI
load|нагрузка, нагружать|lqud
loaded|загруженный|'lqudId
loaf|буханка хлеба|lquf
locally|в местных масштабах|'lqukqlI
locate|определять местонахождение|lqu'keIt
lockout|локаут|
locomotive|локомотив|'lqukq,mqutIv
lodge|домик, будка|lOdZ
long-distance|дальний|'lON'dIstqns
long-standing|давнишний|'lON'stxndIN
long-term|долгосрочный|'lONtq:m
long-time|долгосрочный|
loom|принимать размеры|lu:m
loop|петля|lu:p
loot|ограбление|lu:t
losing|проигрыш, проигранный|'lu:zIN
lost|утраченный|lOst
loud|громкий|laud
loudly|громко|'laudlI
lounge|ленивая походка, сидеть развалясь|laundZ
lovely|красивый|'lAvlI
loving|любящий|'lAvIN
loyalty|лояльность|'lOIqltI
lucid|понятный|'lu:sId
luck|судьба|lAk
lump|глыба, ком|lAmp
lunch|ленч, завтракать|lAntS
luncheon|завтрак|'lAntSqn
lure|завлекать|ljuq
luxurious|роскошный|lAg'zjuqrIqs
luxury|роскошь|'lAkSqrI
lyric|лирическое стихотворение|'lIrIk
machinist|инженер|mq'Si:nIst
mad|безумный|mxd
magnetic|магнитный|mxg'netIk
magnificent|великолепный|mxg'nIfIsnt
maid|девица|meId
maiden|дева|'meIdn
mainland|материк|'meInlqnd
major|майор|'meIdZq
malice|злоба|'mxlIs
man|укомплектовывать личным составом|mxn
man-power|рабочая сила|
managerial|директорский|,mxnq'dZIqrIql
mandate|мандат|'mxndeIt
mandatory|мандатный|'mxndqtqrI
manipulate|манипулировать|mq'nIpjuleIt
mankind|человечество|mxn'kaInd
manoeuvre|маневр, маневрировать|mq'nu:vq
mansion|дворец|'mxnSqn
manual|ручной|'mxnjuql
manually|вручную|
manuscript|рукопись|'mxnjuskrIpt
map|карта|mxp
marginal|предельный|'mQ:dZInql
marginally|предельно|'mQ:dZInqlI
marine|морской флот, морской|mq'ri:n
marital|супружеский|'mxrItl
maritime|морской|'mxrItaIm
mark|признак|mQ:k
marker|маркер|'mQ:kq
martial|военный|'mQ:Sql
mass|собирать|mxs
massacre|резня, устраивать резню|'mxsqkq
master|справляться|'mQ:stq
maternity|материнство|mq'tq:nItI
mathematical|математический|,mxTI'mxtIkql
mathematics|математика|,mxTI'mxtIks
mature|зрелый, созреть|mq'tjuq
maturity|зрелость|mq'tjuqrItI
maxi|макси|'mxksI
maybe|возможно|'meIbi:
meal|еда|mi:l
meaning|значение, смысл|'mi:nIN
meaningless|бессмысленный|'mi:nINlIs
measuring|измерение|
mechanic|механик|mI'kxnIk
mechanical|механический|mI'kxnIkql
mechanism|устройство|'mekqnIzm
mechanization|механизация|,mekqnaI'zeISqn
medal|медаль|'medl
mediator|посредник|'mi:dIeItq
medieval|средневековый|,medI'i:vql
melodic|мелодический|mI'lOdIk
melodious|мелодичный|mI'lqudjqs
melody|мелодия|'melqdI
memorable|памятный|'memqrqbl
memorandum|меморандум|,memq'rxndqm
memorial|памятный|mI'mO:rIql
mentally|умственно|'mentqlI
menu|меню|'menju:
mercenary|наемник|'mq:sInqrI
merchandise|торговля|'mq:tSqndaIz
mercy|милосердие|'mq:sI
mere|единственный|mIq
merit|достоинство|'merIt
meter|метр, счетчик|'mi:tq
methodist|методист|'meTqdIst
mew|мяукать|mju:
microphone|микрофон|'maIkrqfqun
mid|средний|mId
middle-aged|средних лет|'mIdl'eIdZd
middle-class|относящийся к средним слоям общества|
midst|середина|mIdst
midway|на полпути|'mId'weI
midweek|середина недели|
migration|миграция|maI'greISqn
mild|умеренный|maIld
militancy|воинственность|'mIlItqnsI
militant|воинственный|'mIlItqnt
mill|молоть|mIl
mind|помнить|maInd
mineworker|шахтер|
mini|мини|
minimize|доводить до минимума|'mInImaIz
minimum|минимум|'mInImqm
mining|горный|'maInIN
ministerial|министерский|,mInIs'tIqrIql
minute|мелкий|maI'nju:t
miracle|чудо|'mIrqkl
misfortune|несчастье|mIs'fO:tSqn
mislead|вводить в заблуждение|mIs'li:d
missionary|миссионер|'mISnqrI
mistress|хозяйка, госпожа|'mIstrIs
misunderstanding|неправильное понимание|'mIsAndq'stxndIN
mob|шайка|mOb
mobile|подвижный|'mqubaIl
mobility|мобильность|mqu'bIlItI
mobilize|мобилизовать|'mqubIlaIz
mock|насмехаться|mOk
modernize|модернизировать|'mOdqnaIz
modify|модифицировать|'mOdIfaI
momentum|импульс|mqu'mentqm
monetary|денежный|'mAnItqrI
monk|монах|mANk
monster|чудовище|'mOnstq
monthly|ежемесячный|'mAnTlI
monument|памятник|'mOnjumqnt
monumental|увековечивающий|,mOnju'mentl
mood|настроение|mu:d
moral|моральный|'mOrql
moreover|кроме того|mO:'rquvq
motel|мотель|mqu'tel
motive|повод, мотив|'mqutIv
motor|ехать на автомобиле|'mqutq
motor-cycle|мотоцикл|
motorship|теплоход|
mould|формовать|mquld
mourn|сетовать|mO:n
mouth|рот|mauT
mover|движущая сила|'mu:vq
movie|кинофильм|'mu:vI
mud|грязь|mAd
mug|грабить на улице|mAg
mugging|грабеж с насилием|'mAgIN
multilateral|многосторонний|'mAltI'lxtqrql
multiple|многократный|'mAltIpl
multiracial|многорасовый|
multitude|множество|'mAltItju:d
municipalization|муниципализация|
muscle|мускул|'mAsl
myriad|несметное число|'mIrIqd
mysterious|таинственный|mIs'tIqrIqs
mystery|тайна|'mIstqrI
myth|миф|mIT
naked|голый, обнаженный|'neIkId
namely|а именно|'neImlI
narrow|узкий|'nxrqu
natal|относящийся к рождению|'neItl
nation-wide|всенародный|
nationalism|национализм|'nxSnqlIzm
nationality|национальность|,nxSq'nxlItI
nationalization|национализация|,nxSnqlaI'zeISqn
nationalize|национализировать|'nxSnqlaIz
nationally|всенародно|'nxSnqlI
naturally|естественно|'nxtSrqlI
navigator|мореплаватель|'nxvIgeItq
needlework|шитье|'ni:dlwq:k
needy|нуждающийся|'ni:dI
negligence|небрежность|'neglIdZqns
neighbouring|соседний|'neIbqrIN
nerve|мужество|nq:v
nervous|нервный|'nq:vqs
nest|гнездо|nest
net|сеть|net
neurologist|невропатолог|njuq'rOlqdZIst
neurotic|невротический|njuq'rOtIk
neutral|нейтральный|'nju:trql
neutrality|нейтралитет|nju(:)'trxlItI
newcomer|новичок|
newmarket|длинное пальто в талию|'nju:,mQ:kIt
newsletter|новости|
newsman|газетчик|
next|затем, после, рядом с, около|nekst
nicely|хорошо|'naIslI
nightingale|соловей|'naItINgeIl
nightly|ночью|'naItlI
nineteen|девятнадцать|'naIn'ti:n
ninth|девятый|naInT
nitrogen|азот|'naItrqdZqn
nod|кивать|nOd
noise|шум|nOIz
nominal|номинальный|'nOmInl
nominate|выставлять кандидата|'nOmIneIt
non-nuclear|неядерный|'nOn'nju:klIq
non-union|непрофсоюзный|'nOn'ju:njqn
noon|полдень|nu:n
normalization|нормализация|,nO:mqlaI'zeISqn
north|к северу, на север|nO:T
nose|нос|nquz
notable|заметный|'nqutqbl
notably|исключительно|'nqutqblI
notion|понятие|'nquSqn
novel|роман|'nOvql
novelist|романист|'nOvqlIst
novice|новичок|'nOvIs
nowadays|в наше время|'nauqdeIz
nowhere|нигде, никуда|'nquwFq
nuclear-free|свободный от ядерного оружия|
nuisance|досада|'nju:sns
numerous|многочисленный|'nju:mqrqs
nylon|нейлон|'naIlqn
oak|дуб|quk
obey|подчиняться|q'beI
object|объект|'ObdZIkt
objective|объективный|qb'dZektIv
obligation|обязательство|,OblI'geISqn
oblige|обязывать|q'blaIdZ
obscene|непристойный|Ob'si:n
obscenity|непристойность|Ob'si:nItI
obsession|одержимость|qb'seSqn
obstacle|препятствие|'Obstqkl
obstruct|препятствовать|qb'strAkt
obtainable|доступный|qb'teInqbl
occasional|случайный|q'keIZqnl
occasionally|изредка|q'keIZnqlI
occupancy|занятие|'OkjupqnsI
occupant|житель|'Okjupqnt
offend|обижать|q'fend
offender|обидчик|q'fendq
offensive|наступление|q'fensIv
offering|предложение|'OfqrIN
officially|официально|q'fISqlI
offset|компенсировать|'Ofset
offshore|находящийся на расстоянии от берега|'Of'SO:
ominous|зловещий|'OmInqs
onto|на|'Ontu
opener|инструмент для открывания|'qupnq
openly|открыто|'qupnlI
operatic|оперный|,Opq'rxtIk
operational|операционный|,Opq'reISqnl
operative|действующий|'OpqrqtIv
opt|выбирать|Opt
option|выбор|'OpSqn
orbit|орбита|'O:bIt
orbital|орбитальный|'O:bItl
orchestral|оркестровый|O:'kestrql
ordinarily|обычно|'O:dnrIlI
ore|руда|O:
organized|организованный|'O:gqnaIzd
origin|источник|'OrIdZIn
originally|первоначально|q'rIdZInqlI
originate|давать начало|q'rIdZIneIt
orthodox|ортодоксальный|'O:TqdOks
other|в сочетании|'ADq
ours|наш|'auqz
ourselves|себя|,auq'selvz
ouster|выселение|'austq
outbreak|взрыв|'autbreIk
outburst|вспышка|'autbq:st
outdoor|находящийся на открытом воздухе|'autdO:
outer|внешний|'autq
outfield|дальняя часть поля|'autfi:ld
outgo|превосходить|'autgqu
outlet|выходное отверстие|'autlet
outline|очерк, эскиз, обрисовать|'autlaIn
outlook|перспектива|'autluk
outrage|преступать закон|'autreIdZ
outrageous|неистовый|aut'reIdZqs
outright|прямо|'autraIt
outset|начало|'autset
outside|наружная сторона, вне, кроме|'aut'saId
outsider|аутсайдер|'aut'saIdq
ovation|овация|qu'veISqn
overlap|перекрывать|,quvq'lxp
overload|перегружать|'quvq'lqud
overtake|догонять|'quvq'teIk
overthrow|свергать|,quvq'Trqu
overwhelm|преодолеть|,quvq'welm
overwhelmingly|чрезвычайно|,quvq'welmINlI
owe|быть должным|qu
owing|должный|'quIN
p.m.|после полудня|
packet|пакет|'pxkIt
pagoda|пагода|pq'gqudq
pain|боль|peIn
painful|болезненный|'peInful
pairing|сочетание|
pale|бледный|peIl
palm|ладонь|pQ:m
pamphlet|памфлет|'pxmflIt
pan|сковорода|pxn
pancake|блин|'pxnkeIk
panic|паника|'pxnIk
parachute|парашют|'pxrqSu:t
parade|строить|pq'reId
paradise|галерка|'pxrqdaIs
paradox|парадокс|'pxrqdOks
paragraph|параграф|'pxrqgrQ:f
parallel|параллельный|'pxrqlel
parcel|пакет|'pQ:sl
parish|церковный приход|'pxrIS
parity|равенство|'pxrItI
park|парк, парковать|pQ:k
parking|стоянка автомашин|'pQ:kIN
parkway|аллея|'pQ:kweI
parliamentarian|парламентарий|,pQ:lqmen'tFqrIqn
partial|частичный|'pQ:Sql
partition|разделение|pQ:'tISqn
partnership|участие|'pQ:tnqSIp
passing|прохождение|'pQ:sIN
passion|страсть|'pxSqn
passionate|страстный|'pxSqnIt
passionately|страстно|
passport|паспорт|'pQ:spO:t
past|за, после|pQ:st
pat|хлопок|pxt
patch|заплата|pxtS
path|путь|pQ:T
patient|терпеливый|'peISqnt
patriarch|патриарх|'peItrIQ:k
patrol|патруль|pq'trqul
pause|пауза|pO:z
pave|мостить|peIv
pavement|тротуар|'peIvmqnt
pavilion|павильон|pq'vIljqn
payable|подлежащий оплате|'peIqbl
paying|платеж|'peIIN
peacefully|мирно|
peach|персик|pi:tS
peanut|арахис|'pi:nAt
pear|груша|pFq
pearl|жемчуг|pq:l
peasant|крестьянин|'pezqnt
peculiar|особенный|pI'kju:ljq
peddler|разносчик|'pedlq
peer|пэр|pIq
penny|пенни|'penI
perfect|совершенный|'pq:fIkt
perfectly|совершенно|'pq:fIktlI
peril|опасность|'perIl
periodic|периодический|,pq:raI'OdIk
permanently|постоянно|'pq:mqnqntlI
permissible|допустимый|pq'mIsqbl
persecution|преследование|,pq:sI'kju:Sqn
persist|упорствовать|pq'sIst
persistent|настойчивый|pq'sIstqnt
persistently|настойчиво|
personally|лично|'pq:snqlI
perspective|перспектива, перспективный|pq'spektIv
pessimism|пессимизм|'pesImIzm
petroleum|нефть|pI'trquljqm
phase|фаза, фазировать|feIz
philharmonic|филармония|,fIlQ:'mOnIk
philosophical|философский|,fIlq'sOfIkql
phone|телефон, звонить по телефону|fqun
photograph|фотография, фотографировать|'fqutqgrQ:f
photographer|фотограф|fq'tOgrqfq
photographic|фотографический|,fqutq'grxfIk
physical|физический|'fIzIkql
physically|физически|'fIzIk(q)lI
physician|врач|fI'zISqn
piano|фортепьяно|'pjQ:nqu
picnic|пикник|'pIknIk
pier|пирс, устой|pIq
pierce|пронзать|pIqs
pig|свинья|pIg
pile|кипа, куча, складывать|paIl
pill|пилюля|pIl
pint|пинта|paInt
pipe|труба|paIp
pistol|пистолет|'pIstl
pitch|бросок, уровень, сооружать|pItS
pitcher|подающий|'pItSq
pity|жалость|'pItI
placard|афиша|'plxkQ:d
plain|равнина, понятный|pleIn
plaint|жаловаться|pleInt
plaintiff|истец|'pleIntIf
plane|парить|pleIn
planet|планета|'plxnIt
plant|сажать|plQ:nt
planting|плантация|
plasma|плазма|'plxzmq
plaster|пластырь|'plQ:stq
plateau|плато|'plxtqu
platform|платформа|'plxtfO:m
platitude|банальность|'plxtItju:d
playwright|драматург|'pleIraIt
plea|просьба|pli:
pleasant|приятный|'pleznt
plenary|неограниченный|'pli:nqrI
plenum|пленум|'pli:nqm
plot|составлять план|plOt
plough|пахать|plau
plunge|нырять|plAndZ
pocket|карман|'pOkIt
poem|поэма|'pquIm
poetry|поэзия, стихи|'pquItrI
poise|уравновешивать|pOIz
poison|яд, отравлять|'pOIzn
polish|полировать|'pqulIS
polite|вежливый|pq'laIt
politic|политичный|'pOlItIk
politician|политик|,pOlI'tISqn
poll|проводить согласование|pOl
pollution|загрязнение|pq'lu:Sqn
polytechnic|политехнический институт|,pOlI'teknIk
pond|пруд|pOnd
pool|общий фонд|pu:l
pop|в стиле "поп"|pOp
popularity|популярность|,pOpju'lxrItI
porcelain|фарфор|'pO:sqlIn
porter|швейцар|'pO:tq
portion|часть, доля|'pO:Sqn
possession|владение|pq'zeSqn
post|отправлять по почте|pqust
post-war|послевоенный|
poster|рекламировать|'pqustq
potato|картофель|pq'teItqu
potentially|потенциально|pqu'tenSqlI
poultry|домашняя птица|'pqultrI
pounce|налетать|pauns
pour|лить|pO:
powder|порошок|'paudq
power|снабжать силовым двигателем|'pauq
powerfully|сильно|
practicable|осуществимый|'prxktIkqbl
practically|практический|'prxktIkqlI
practise|практиковать|'prxktIs
prairie|прерия|'prFqrI
pray|молить|preI
preach|проповедовать|pri:tS
precarious|ненадежный|prI'kFqrIqs
precaution|предосторожность|prI'kO:Sqn
precede|предшествовать|prI(:)'si:d
precedent|прецедент|prI'si:dqnt
precisely|точно|prI'saIslI
precision|точность|prI'sIZqn
predecessor|предшественник|'pri:dIsesq
prejudice|предубеждение|'predZudIs
preliminary|предварительный|prI'lImInqrI
prelude|вступление|'prelju:d
premature|преждевременный|,premq'tjuq
prematurely|преждевременно|
premiere|премьера|'premIFq
premise|предпосылка|prI'maIz
preparatory|подготовительный|prI'pxrqtqrI
prepared|готовый|prI'pFqd
preponderant|преобладающий|prI'pOndqrqnt
prescribe|предписывать|prIs'kraIb
presentation|предъявление|,prezen'teISqn
preside|председательствовать|prI'zaId
presidency|президентство|'prezIdqnsI
presidential|президентский|,prezI'denSql
presidium|президиум|prI'sIdIqm
presumably|возможно|prI'zju:mqblI
presume|предполагать|prI'zju:m
pretend|использовать в качестве предлога|prI'tend
pretext|предлог|'pri:tekst
pretty|довольно|'prItI
prevention|предотвращение|prI'venSqn
preview|предварительный показ кинофильма|'pri:vju:
prewar|довоенный|
prey|жертва|preI
price|цена, оценивать|praIs
pride|гордость|praId
priest|священник|pri:st
primate|архиепископ|'praImIt
primitive|примитивный|'prImItIv
principally|главным образом|'prInsqpqlI
printer|типограф|'prIntq
prior|прежний|'praIq
priority|приоритет|praI'OrItI
privacy|уединенность|'prIvqsI
privately|конфиденциально|'praIvItlI
privilege|привилегия|'prIvIlIdZ
probability|вероятность|,prObq'bIlItI
probable|вероятный|'prObqbl
probe|зонд|prqub
process|обрабатывать|'prquses
productive|производительный|prq'dAktIv
professor|профессор|prq'fesq
profit|быть полезным|'prOfIt
programme|планировать|'prqugrxm
prohibit|запрещать|prq'hIbIt
prohibition|запрещение|,prquI'bISqn
prolong|продлевать|prqu'lON
promising|многообещающий|'prOmIsIN
promoter|покровитель|prq'mqutq
promptly|быстро|'prOmptlI
prone|склонный|prqun
pronounce|произносить|prq'nauns
proof|доказательство|pru:f
propagation|распространение|,prOpq'geISqn
proposition|предложение|,prOpq'zISqn
proprietor|владелец|prq'praIqtq
propulsion|движение вперед|prq'pAlSqn
prosecute|преследовать в судебном порядке|'prOsIkju:t
prosecutor|обвинитель|'prOsIkju:tq
prospect|исследовать|'prOspekt
prosperity|процветание|prOs'perItI
prosperous|преуспевающий|'prOspqrqs
protective|защитный|prq'tektIv
protestant|протестант|'prOtIstqnt
protester|участник кампании протеста|
prototype|прототип|'prqutqutaIp
proud|гордый|praud
proudly|гордо|'praudlI
provision|обеспечение|prq'vIZqn
provisionals|"временные"|
provocation|провокация|,prOvq'keISqn
provocative|провокационный|prq'vOkqtIv
psychological|психологический|,saIkq'lOdZIkql
psychology|психология|saI'kOlqdZI
pub|пивной бар|pAb
publishing|издательское дело|'pAblISIN
pulp|сенсационный рассказ|pAlp
punch|перфорировать|pAntS
punish|наказывать|'pAnIS
puppy|щенок|'pApI
purchaser|покупатель|'pq:tSqsq
pure|чистый|pjuq
purely|исключительно|'pjuqlI
purse|кошелек|pq:s
puzzle|озадачивать|'pAzl
quarrel|ссора|'kwOrql
quarterly|квартальный|'kwO:tqlI
question|спрашивать|'kwestSqn
queue|очередь|kju:
quintet|квинтет|kwIn'tet
quit|увольнение|kwIt
quota|квота|'kwqutq
quotation|цитата|kwqu'teISqn
quote|цитировать|kwqut
racialist|расист|'reISqlIst
racing|состязание в скорости|'reIsIN
rack|напрягать|rxk
racket|рэкет|'rxkIt
radar|радиолокатор|'reIdq
radical|радикал|'rxdIkql
radioactive|радиоактивный|'reIdIqu'xktIv
radioactivity|радиоактивность|'reIdIquxk'tIvItI
radius|радиус|'reIdjqs
raid|рейд|reId
railroad|железная дорога|'reIlrqud
railwayman|железнодорожник|
rainbow|радуга|'reInbqu
rainless|засушливый|'reInlIs
raised|рельефный|reIzd
raising|выращивание|
rally|собирать|'rxlI
ranger|скиталец|'reIndZq
rape|насиловать|reIp
rapid|быстрый|'rxpId
rare|резкий|rFq
rarely|редко|'rFqlI
rate|оценивать|reIt
ratepayer|налогоплательщик|'reIt,peIq
ratify|ратифицировать|'rxtIfaI
ration|паек|'rxSqn
rational|рациональный|'rxSqnl
rationalization|рационализация|,rxSnqlaI'zeISqn
re-equip|переоборудовать|
re-establish|восстанавливать|
re-examine|вновь исследовать|
react|реагировать|rI(:)'xkt
reactionary|реакционер, реакционный|rI(:)'xkSnqrI
reactor|реактор|rI(:)'xktq
read|чтение|ri:d
readily|охотно|'redIlI
readiness|находчивость|'redInIs
realization|реализация|,rIqlaI'zeISqn
rear|задний|rIq
reason|рассуждать|'ri:zn
reasonably|разумно|'ri:znqblI
reassign|вновь назначать|
reassure|заверять|,ri:q'Suq
rebate|сокращать|'ri:beIt
rebellion|восстание|rI'beljqn
recapture|взять обратно|'ri:'kxptSq
receipt|расписка|rI'si:t
receiver|получатель|rI'si:vq
reception|прием|rI'sepSqn
recess|перерыв в работе|rI'ses
recession|уход|rI'seSqn
recipe|рецепт|'resIpI
recipient|получатель|rI'sIpIqnt
reckon|считать|'rekqn
reconciliation|примирение|,rekqnsIlI'eISqn
reconsider|пересматривать|'ri:kqn'sIdq
reconstruction|реконструкция|'ri:kqns'trAkSqn
recorder|регистратор|rI'kO:dq
recording|регистрация|rI'kO:dIN
recover|выздоравливать|'ri:'kAvq
recreation|воссоздание|'ri:krI'eISqn
recruitment|вербовка|rI'kru:tmqnt
rector|ректор|'rektq
redistribution|перераспределение|'ri:,dIstrI'bju:Sqn
redouble|усиливать|rI'dAbl
redress|исправлять|rI'dres
redundancy|избыток|rI'dAndqnsI
referee|рефери|,refq'ri:
referendum|референдум|,refq'rendqm
refine|очищать|rI'faIn
reflation|новая инфляция|
reflecting|отражающий|
reformism|реформизм|
refuge|убежище|'refju:dZ
refund|возмещать убытки|ri:'fAnd
regain|вновь приобрести|rI'geIn
regard|внимание|rI'gQ:d
regent|регент|'ri:dZqnt
regiment|полк|'redZImqnt
regret|сожаление|rI'gret
rehabilitation|реабилитация|'ri:q,bIlI'teISqn
rehearsal|репетиция|rI'hq:sql
rehouse|переселять в новые дома|'ri:'haus
reign|царствовать|reIn
reinforce|усиливать|,ri:In'fO:s
reinstate|восстанавливать|'ri:In'steIt
reiterate|повторять|ri:'ItqreIt
rejection|отказ|rI'dZekSqn
relative|родственник|'relqtIv
relax|ослаблять|rI'lxks
relay|смена|rI'leI
released|освобожденный|
relegation|высылка|,relI'geISqn
relevant|имеющий отношение|'relIvqnt
reliable|надежный|rI'laIqbl
relieve|облегчать|rI'li:v
religion|религия|rI'lIdZqn
reluctance|неохота|rI'lAktqns
reluctant|делающий с неохотой|rI'lAktqnt
reluctantly|неохотно|rI'lAktqntlI
rely|полагаться|rI'laI
remainder|остаток|rI'meIndq
remand|отчислять|rI'mQ:nd
remark|замечание, замечать|'rI'mQ:k
remarkably|замечательно|rI'mQ:kqblI
remedy|средство|'remIdI
renaissance|возрождение|rq'neIsqns
render|отдавать|'rendq
rendezvous|свидание|'rOndIvu:
renewal|обновление|rI'nju(:)ql
rent|сдавать внаем|rent
rental|сумма арендной платы|'rentl
reopen|возобновлять|'ri:'qupqn
reorganization|реорганизация|'ri:,O:gqnaI'zeISqn
repay|оплачивать|'ri:'peI
repeal|аннулирование|rI'pi:l
repertoire|репертуар|'repqtwQ:
repetition|повторение|,repI'tISqn
replacement|замещение|rI'pleIsmqnt
reported|сообщенный|rI'pO:tId
reprint|переиздание|'ri:'prInt
reproduction|воспроизведение|,ri:prq'dAkSqn
repudiation|отрицание|rI,pju:dI'eISqn
reputation|репутация|,repju(:)'teISqn
resale|перепродажа|'ri:'seIl
rescuer|спаситель|'reskjuq
reselection|повторный отбор|
resemble|походить|rI'zembl
reservist|резервист|rI'zq:vIst
reservoir|резервуар|'rezqvwQ:
residence|резиденция|'rezIdqns
residential|жилой|,rezI'denSql
resist|сопротивляться|rI'zIst
respective|соответственный|rIs'pektIv
respectively|соответственно|rIs'pektIvlI
respond|отвечать|rIs'pOnd
rest|оставаться|rest
restoration|реставрация|,restq'reISqn
restrain|сдерживать|rIs'treIn
restrictive|ограничительный|rIs'trIktIv
resumption|возвращение|rI'zAmpSqn
retail|розничная продажа|ri:'teIl
retaliation|возмездие|rI,txlI'eISqn
retard|задерживать|rI'tQ:d
retention|удерживание|rI'tenSqn
retired|отставной|rI'taIqd
retiring|скромный|rI'taIqrIN
reunification|воссоединение|
revelation|открытие|,revI'leISqn
revenge|реванш|rI'vendZ
reversal|полное изменение|rI'vq:sql
revert|возвращаться|rI'vq:t
revision|пересмотр|rI'vIZqn
revive|оживать|rI'vaIv
revolt|восстать|rI'vqult
rheumatic|ревматический|ru(:)'mxtIk
rheumatism|ревматизм|'ru:mqtIzm
rhythm|ритм|'rIDqm
rib|ребро|rIb
rice|рис|raIs
ride|ехать верхом|raId
rider|всадник|'raIdq
ridge|хребет|rIdZ
ridiculous|смешной|rI'dIkjulqs
ridiculously|смешно|
rifle|винтовка|'raIfl
righthander|удар правой|'raIt,hxndq
rightly|справедливо|'raItlI
rigid|жесткий|'rIdZId
rigorous|суровый|'rIgqrqs
rioter|мятежник|'raIqtq
rip|рвать|rIp
ripe|спелый|raIp
rising|возрастающий|'raIzIN
rivalry|соперничество|'raIvqlrI
roar|реветь|rO:
rob|грабить|rOb
robber|грабитель|'rObq
roll|рулон, катить|rqul
romantic|романтичный|reu'mxntIk
romp|возиться|rOmp
rookie|новичок|'rukI
rope|привязывать|'rqups'end
rotation|вращение|rqu'teISqn
rough|неровный|rAf
round|округлять|raund
roundsman|торговый агент|'raundzmxn
routine|рутина|ru:'ti:n
royalist|реалист|'rOIqlIst
royalty|королевская власть|'rOIqltI
rubber|резина|'rAbq
rug|ковер|rAg
ruin|гибель|ruIn
ruler|правитель|'ru:lq
ruling|управление|'ru:lIN
rumour|слух|'ru:mq
runner|бегун|'rAnq
runner-up|участник состязания|
running|пробег, бегущий|'rAnIN
rural|сельский|'ruqrql
rush|натиск, бросаться|rAS
rye|рожь|raI
sack|мешок|sxk
sacking|увольнение|'sxkIN
sacrifice|жертва, приносить в жертву|'sxkrIfaIs
sad|печальный|sxd
saddle|седло|'sxdl
sadly|печально|
saga|сага|'sQ:gq
sail|плавать|seIl
sailor|моряк|'seIlq
saint|святой|seInt
saint (St.)|святой|
salad|салат|'sxlqd
salary|зарплата|'sxlqrI
salesman|продавец|'seIlzmqn
salute|приветствовать|sq'lu:t
salvation|спасение|sxl'veISqn
sample|образец|'sQ:mpl
sanction|санкция|'sxNkSqn
sand|песок|sxnd
sandwich|бутерброд|'sxnwIdZ
sandy|песчаный|'sxndI
sanitary|санитарный|'sxnItqrI
satellite|спутник|'sxtqlaIt
satin|атлас|'sxtIn
satirical|сатирический|sq'tIrIkql
satisfactorily|удовлетворительно|,sxtIs'fxktqrqlI
sausage|колбаса|'sOsIdZ
savage|дикий|'sxvIdZ
savagely|свирепо|
scarce|скудный|skFqs
scarcely|едва|'skFqslI
scare|паника|skFq
scarf|шарф|skQ:f
scatter|рассеивать|'skxtq
scholarship|эрудиция|'skOlqSIp
scientific|научный|,saIqn'tIfIk
scope|пределы|skqup
scorer|счетчик очков|'skO:rq
scout|разведчик, разведывать|skaut
scrap|выбрасывать|skrxp
scratch|царапать|skrxtS
scream|кричать|skri:m
scrip|временная акция|skrIp
script|рукопись|skrIpt
scrub|тереть|skrAb
scrutiny|тщательный осмотр|'skru:tInI
sculpture|скульптура|'skAlptSq
seal|ставить печать|si:l
seaside|побережье|'si:'saId
seasonal|сезонный|'si:zqnl
second|секунда|'sekqnd
second-hand|подержанный|
secondary|вторичный|'sekqndqrI
secondly|во-вторых|'sekqndlI
sect|секта|sekt
secure|спокойный|sI'kjuq
sedate|спокойный|sI'deIt
seemingly|на вид|'si:mINlI
seldom|редко|'seldqm
selective|отборный|sI'lektIv
selector|отборщик|sI'lektq
seller|торговец|'selq
selling|продажа|
semi-skilled|низкой квалификации|
semifinal|полуфинал|'semI'faInl
seniority|старшинство|,si:nI'OrItI
sensation|чувство|sen'seISqn
sensitive|чувствительный|'sensItIv
separately|сепаратно|
separation|отделение|,sepq'reISqn
sequence|последовательность|'si:kwqns
sergeant|сержант|'sQ:dZqnt
sermon|проповедь|'sq:mqn
serving|порция|
seventeen|семнадцать|'sevn'ti:n
seventy|семьдесят|'sevntI
severely|строго|sI'vIqlI
sew|шить|sju:
shade|тень|SeId
shadow|тень|'Sxdqu
shake|трясти|SeIk
shame|стыд|SeIm
shape|форма, придавать форму|SeIp
shatter|разбить|'Sxtq
shave|брить|SeIv
sheer|настоящий|SIq
shell|снаряд|Sel
shelter|убежище|'Seltq
shepherd|пастух|'Sepqd
shield|защита|Si:ld
shilling|шиллинг|'SIlIN
shine|свет, светить|SaIn
shipowner|судовладелец|'SIp,qunq
shipyard|верфь|'SIpjQ:d
shocking|потрясающий|'SOkIN
shopping|посещение магазина с целью покупки|'SOpIN
shorten|сокращать|'SO:tn
shot-gun|дробовик|
shoulder|плечо|'Squldq
shower|ливень|'Squq
shrine|сохранять|SraIn
shrug|пожимать|SrAg
shy|пугливый|SaI
sick|больной|sIk
sicken|заболевать|'sIkn
sickness|болезнь|'sIknIs
side|боковой, быть на чьей-либо стороне|saId
side-effect|побочный эффект|
sidewalk|тротуар|'saIdwO:k
siege|осада|si:dZ
signal|сигнал|'sIgnl
signatory|сторона|'sIgnqtqrI
signature|подпись|'sIgnItSq
significantly|значительно|
signor|синьор|
silence|молчание|'saIlqns
silo|силосная яма|'saIlqu
similarly|также|'sImIlqlI
simplification|прощение|,sImplIfI'keISqn
simulate|симулировать|'sImjuleIt
simulator|симулянт|'sImjuleItq
simultaneously|одновременно|
single|определять|'sINLgl
sinister|зловещий|'sInIstq
sink|тонуть|sINk
sinking|погружение|'sINkIN
sister|сестра|'sIstq
sit-in|сидячая забастовка|
sixteen|шестнадцать|'sIks'ti:n
sixty|шестьдесят|'sIkstI
sizeable|значительных размеров|
sketch|эскиз|sketS
skipper|шкипер|'skIpq
skirt|юбка|skq:t
sky-scraper|небоскреб|'skaI,skreIpq
slab|плита|slxb
slack|слабый|slxk
slam|хлопанье|slxm
slap|хлопать|slxp
slash|рубить|slxS
slavery|рабство|'sleIvqrI
sleeve|рукав|sli:v
slice|ломоть|slaIs
slide|скользить|slaId
slim|стройный|slIm
slope|наклон|slqup
small-scale|небольшого масштаба|
smart|резкий|smQ:t
smartly|ловко|
smile|улыбаться|smaIl
smoker|курильщик|'smqukq
smoking|курение|
smooth|сглаживание|smu:D
smuggle|заниматься контрабандой|'smAgl
snap|щелкать|snxp
snatch|хватать|snxtS
snowdrop|подснежник|'snqudrOp
soap|мыло|squp
soar|резко подниматься|sO:
socially|социально|'squSqlI
soft|мягкий|sOft
soil|почва|sOIl
solicitor|адвокат|sq'lIsItq
solo|соло|'squlqu
soloist|солист|'squlquIst
somehow|как-нибудь|'sAmhau
something|примерно|'sAmTIN
sometime|когда-нибудь|'sAmtaIm
somewhere|где-то|'sAmwFq
sonny|сынок|'sAnI
sophisticated|сложный|sq'fIstIkeItId
sore|рана|sO:
sort|сортировать|sO:t
sovereign|суверенный|'sOvrIn
sovereignty|суверенитет|'sOvrqntI
soybean|соя|
spacecraft|космический корабль|'speIskrQ:ft
span|интервал|spxn
spare|запасная часть, запасной, беречь|spFq
sparrow|воробей|'spxrqu
specialist|специалист|'speSqlIst
specialize|специализировать|'speSqlaIz
specially|особенно|'speSqlI
species|порода|'spi:Si:z
specify|указывать|'spesIfaI
specimen|образец|'spesImIn
spectacular|эффектный|spek'txkjulq
speed|спешить|spi:d
speedily|быстро|'spi:dIlI
speedway|спидвей|'spi:dweI
sphere|сфера|sfIq
spice|специя|spaIs
spinage|шпинат|
spirited|живой|'spIrItId
spiritual|духовный|'spIrItjuql
splendid|великолепный|'splendId
spoil|портить|spO:Il
sponsorship|попечительство|
spontaneously|спонтанно|
sporting|спортивный|'spO:tIN
squad|команда|skwOd
squadron|эскадрон|'skwOdrqn
square|выпрямлять|skwFq
stability|устойчивость|stq'bIlItI
stagger|шатание, шатать|'stxgq
stamp|штамп|stxmp
stance|поза|stxns
standardize|стандартизировать|'stxndqdaIz
standing|стоящий|'stxndIN
standpoint|точка зрения|'stxndpOInt
standstill|застой|'stxndstIl
starter|стартер|'stQ:tq
station|помещать|'steISqn
statistical|статистический|stq'tIstIkql
stature|рост|,stxtSq
statutory|установленный законом|'stxtjutqrI
steadily|неуклонно|'stedIlI
steam|пар|sti:m
steep|крутой|sti:p
steer|править|stIq
stepmother|мачеха|'step,mADq
stern|строгий|stq:n
stick|палка, втыкать|stIk
stimulate|побуждать|'stImjuleIt
stir|шевелить|stq:
stock-pot|кастрюлька для мясного бульона|
stockpile|запас|'stOkpaIl
stomach|желудок|'stAmqk
storage|хранение|'stO:rIdZ
store|снабжать|stO:
stormy|бурный|'stO:mI
straight|прямо|streIt
straightforward|прямой|streIt'fO:wqd
strangely|странным образом|
strangle|задушить|'strxNgl
straw|солома|strO:
strawberry|земляника|'strO:bqrI
stream|поток, течь|stri:m
strict|точно|strIkt
strictly|строго|'strIktlI
striker|забастовщик|'straIkq
string|веревка|strIN
strip|полоса|strIp
strontium|стронций|'strOnSjqm
studio|студия|'stju:dIqu
studious|прилежный|'stju:djqs
stuff|вещество, набивать|stAf
stumble|спотыкаться|'stAmbl
stump|пень|stAmp
stun|оглушать|stAn
subcontractor|субподрядчик|
subject|подчиненный|'sAbdZIkt
submission|подчинение|sqb'mISqn
subscription|подписание|sqb'skrIpSqn
subsequent|последующий|'sAbsIkwqnt
subsequently|впоследствии|'sAbsIkwqntlI
substance|вещество|'sAbstqns
substitute|замена|'sAbstItju:t
suburb|пригород|'sAbq:b
subversion|свержение|sqb'vq:Sqn
subway|метро|'sAbweI
successfully|успешно|s(q)k'sesfulI
successive|последующий|sqk'sesIv
successor|преемник|sqk'sesq
suffrage|право голоса|'sAfrd
suicide|самоубийство|'sjuIsaId
suit|ходатайство, устраивать|sju:t
suitcase|чемодан|'sju:tkeIs
suitor|проситель|'sju:tq
summarize|суммировать|'sAmqraIz
summary|конспект, суммарный|'sAmqrI
summit|вершина|'sAmIt
sunlight|солнечный свет|'sAnlaIt
sunny|солнечный|'sAnI
sunshine|солнечный свет|'sAnSaIn
superintendent|управляющий|,sju:pqrIn'tendqnt
superior|старший|sju(:)'pIqrIq
superiority|старшинство|sju(:),pIqrI'OrItI
supersonic|сверхзвуковой|'sju:pq'sOnIk
supervision|надзор|,sju:pq'vIZqn
supervisor|надзиратель|'sju:pqvaIzq
supervisory|наблюдательный|,sju:pq'vaIzqrI
supplement|добавление|'sAplIment
supplementary|дополнительный|,sAplI'mentqrI
supplier|поставщик|sq'plaIq
supporting|опорный|sq'pO:tIN
supposedly|предположительно|sq'pquzIdlI
suppress|подавлять|sq'pres
suppression|подавление|sq'preSqn
supremacy|превосходство|sju'premqsI
surplus|излишек|'sq:plqs
surprising|удивительный|sq'praIzIN
surprisingly|удивительно|sq'praIzINlI
surrender|сдача|sq'rendq
suspense|неизвестность|sqs'pens
suspension|подвешивание|sqs'penSqn
suspicious|подозрительный|sqs'pISqs
swallow|глотать|'swOlqu
swan|лебедь|swOn
swear|клясться|swFq
sweep|размах|swi:p
sweet|сладкий|swi:t
swell|надувать|swel
swift|быстрый|swIft
swindler|мошенник|'swIndlq
switchboard|коммутатор|'swItSbO:d
symbol|символ|'sImbql
sympathetic|сочувственный|,sImpq'TetIk
symptom|симптом|'sImptqm
syndicate|синдикат|'sIndIkeIt
synthetic|синтетический|sIn'TetIk
table|составлять таблицы|'teIbl
tablet|таблетка|'txblIt
tabloid|таблетка|'txblOId
tabulation|табулирование|,txbju'leISqn
tack|кнопка|txk
tackle|хватать|'txkl
tactical|тактический|'txktIkql
tailor|портной|'teIlq
takeover|национализация|
talented|талантливый|'txlqntId
tangible|осязаемый|'txndZqbl
tank|танк|txNk
tap|кран|txp
tape|лента|teIp
taunt|насмехаться|tO:nt
taxi|такси|'txksI
taxiway|рулежная дорожка|
taxpayer|налогоплательщик|'txks,peIq
teaching|обучение|'ti:tSIN
team|объединяться|ti:m
technological|технический|
ted|раскидывать|ted
teenage|юношеский|'ti:neIdZ
teenager|подросток|'ti:neIdZq
telecast|телевизионная передача|'telIkQ:st
telegraph|телеграфировать|'telIgrQ:f
televise|передавать по телевидению|'telIvaIz
temperament|темперамент|'tempqrqmqnt
temple|храм|'templ
temporarily|временно|'temprqrqlI
tempt|искушать|tempt
tendency|тенденция|'tendqnsI
tenement|арендное имущество|'tenImqnt
tentative|пробный|'tentqtIv
tenure|владение|'tenjuq
termination|конец|,tq:mI'neISqn
terrace|терраса|'terqs
terribly|страшно|
terrify|ужасать|'terIfaI
territorial|территориальный|,terI'tO:rIql
terror|страх|'terq
terrorism|терроризм|'terqrIzm
testament|завещание|'testqmqnt
testify|свидетельствовать|'testIfaI
testing|испытание|
text|текст|tekst
textbook|учебник|'tekstbuk
theatrical|театральный|TI'xtrIkql
theoretical|теоретический|TIq'retIkql
therapy|терапия|'TerqpI
thereby|таким образом|'DFq'baI
thesis|тезис|'Ti:sIs
thick|толстый|TIk
thief|вор|Ti:f
thin|тонкий|TIn
thinker|мыслитель|'TINkq
thirty|тридцать|'Tq:tI
thorough|тщательный|'TArq
thread|нитка|Tred
three-quarter|трехчетвертной|'Tri:'kwO:tq
thresher|молотильщик|'TreSq
thrill|волновать|TrIl
thug|убийца|TAg
thunder|греметь|'TAndq
tide|прилив и отлив|taId
tiger|тигр|'taIgq
tighten|сжимать|'taItn
tights|трико|taIts
till|не раньше|tIl
timber|лесоматериал|'tImbq
time|рассчитывать|taIm
timetable|расписание|
tin|олово|tIn
tiny|крошечный|'taInI
tip|кончик, наклонять|tIp
toast|тост|tqust
tobacco|табак|tq'bxkqu
toe|касаться|tqu
tolerate|терпеть|'tOlqreIt
tongue|язык|tAN
tool|инструмент, действовать|tu:l
toolroom|инструментальный цех|'tu:lrum
tooth|зуб|tu:T
toothpaste|зубная паста|
top|достигать уровня|tOp
topic|тема|'tOpIk
topple|валиться|'tOpl
toss|метание|tOs
total|подводить итог|'tqutl
toughen|делать жестким|'tAfn
tourney|турнир|'tuqnI
towards|к, по|tq'wO:dz
toy|игрушка|tOI
trace|следить|treIs
trade|торговать|treId
tradition|традиция|trq'dISqn
traditionally|традиционно|trq'dISnqlI
tragedy|трагедия|'trxdZIdI
tragic|трагический|'trxdZIk
train|поезд|treIn
trained|обученный|treInd
tramp|бродяга|trxmp
transatlantic|трансатлантический|'trxnzqt'lxntIk
transfix|пронзать|trxns'fIks
transform|преобразовывать|trxns'fO:m
transformation|преобразование|,trxnsfq'meISqn
transition|переход|trxn'sIZqn
translate|переводить|trxns'leIt
translation|перевод|trxns'leISqn
transmission|передача|trxnz'mISqn
transportation|перевозка|,trxnspO:'teISqn
traveller|путешественник|'trxvlqz'dZOI
travesty|пародия|'trxvIstI
tray|поднос|treI
treasurer|казначей|'treZqrq
treat|удовольствие|tri:t
tribal|родовой|'traIbql
tribe|род|traIb
tribune|трибуна|'trIbju:n
trick|хитрость|trIk
trickle|струйка|'trIkl
trim|порядок|trIm
triple|тройной|'trIpl
triumphal|триумфальный|traI'Amfql
trolley|тележка|'trOlI
trophy|трофей|'trqufI
trot|идти рысью|trOt
troubled|беспокойный|'trAbld
truant|прогульщик|'tru(:)qnt
true|правдиво|tru:
truncheon|дубинка полицейского|'trAntSqn
trustee|попечитель|trAs'ti:
tube|труба|tju:b
tune|мелодия|tju:n
tunnel|туннель|'tAnl
turf|дерн|tq:f
turmoil|суматоха|'tq:mOIl
turn|оборот|tq:n
turner|гимнаст|'tq:nq
twice|дважды|twaIs
twin|двойник|twIn
twist|крутить|twIst
twisted|искривленный|
two-way|двусторонний|'tu:'weI
type|писать на машинке|taIp
typical|типичный|'tIpIkql
ugly|безобразный|'AglI
ultimate|последний|'AltImIt
ultimatum|ультиматум|,AltI'meItqm
ultra-left|ультралевый|
ultra-right|ультраправый|
unanimous|единодушный|ju(:)'nxnImqs
unarmed|безоружный|'An'Q:md
unaware|незнающий|'Anq'wFq
unbearably|невыносимо|
unbeaten|непроторенный|'An'bi:tn
uncertain|неясный|An'sq:tn
unchanged|неизменившийся|'An'tSeIndZd
uncomfortable|неудобный|An'kAmfqtqbl
uncommon|необыкновенный|An'kOmqn
under|книзу, ниже|'Andq
under-secretary|заместитель министра|
undergo|испытывать|,Andq'gqu
underline|подчеркивать|,Andq'laIn
underlying|лежащий в основе|,Andq'laIIN
undermine|подрывать|,Andq'maIn
understandably|понятно|
undertaking|предприятие|,Andq'teIkIN
undesirable|нежелательный|'AndI'zaIqrqbl
undoubtedly|несомненно|
unexpected|неожиданный|'AnIks'pektId
unfair|несправедливый|,An'feq
unfairly|несправедливо|
unfavourable|неблагоприятный|'An'feIvqrqbl
unfortunate|несчастливый|An'fO:tSnIt
unfortunately|к несчастью|
unhappy|несчастный|An'hxpI
uniformed|одетый в форму|'ju:nIfO:md
unify|объединять|'ju:nIfaI
unilateral|односторонний|'ju:nI'lxtqrql
universal|всеобщий|,ju:nI'vq:sql
unlike|непохожий|'An'laIk
unlimited|неограниченный|An'lImItId
unlucky|неудачный|An'lAkI
unnecessary|ненужный|An'nesIsqrI
unofficial|неофициальный|'Anq'fISql
unpleasant|неприятный|An'pleznt
unprecedented|беспрецедентный|An'presIdqntId
unpredictable|непредсказуемый|'AnprI'dIktqbl
unresolved|нерешенный|'AnrI'zOlvd
unrest|беспокойство|'An'rest
unsatisfactory|неудовлетворительный|'An,sxtIs'fxktqrI
unspeakable|невыразимый|An'spi:kqbl
unsuccessful|неудачный|'Ansqk'sesful
unsuccessfully|неудачно|
untrue|неверный|'An'tru:
unusually|необычно|An'ju:ZuqlI
unwise|неразумный|'An'waIz
uphold|поддерживать|Ap'hquld
upstairs|наверху|'Ap'stFqz
uranium|уран|ju'reInjqm
urgency|срочность|'q:dZqnsI
urn|урна|q:n
used|использованный|ju:zd
useless|бесполезный|'ju:slIs
user|потребитель|'ju:zq
usually|обычно|'ju:ZuqlI
utility|полезность|ju(:)'tIlItI
utmost|крайний|'Atmqust
utter|произносить|'Atq
vacancy|вакансия|'veIkqnsI
vacant|незанятый|'veIkqnt
vacate|освобождать|vq'keIt
vacation|каникулы|vq'keISqn
vague|неопределенный|veIg
valid|действительный|'vxlId
valuation|оценка|,vxlju'eISqn
value|оценивать|'vxlju:
van|авангард|vxn
vanish|исчезать|'vxnIS
vassal|вассал|'vxsql
vastly|значительно|'vQ:stlI
vault|свод|vO:lt
vegetable|растительный|'vedZItqbl
vehemently|сильно|
vein|вена|veIn
venture|рискованное предприятие|'ventSq
vertical|вертикальный|'vq:tIkql
veto|вето|'vi:tqu
via|через|'vaIq
viable|жизнеспособный|'vaIqbl
vicar|викарий|'vIkq
vice-chairman|заместитель председателя|'vaIs'tSFqmqn
victimization|преследование|,vIktImaI'zeISqn
view|осматривать|vju:
viewpoint|точка зрения|'vju:pOInt
vigorous|сильный|'vIgqrqs
vigorously|сила|'vIgqrqslI
vigour|сила|'vIgq
viking|викинг|'vaIkIN
villa|вилла|'vIlq
villager|сельский житель|'vIlIdZq
violate|нарушать|'vaIqleIt
violent|неистовый|'vaIqlqnt
violently|неистово|'vaIqlqntlI
violin|скрипка|,vaIq'lIn
virgin|девственный|'vq:dZIn
virtual|фактический|'vq:tjuql
virtually|фактически|'vq:tjuqlI
virtue|добродетель|'vq:tju:
vision|зрение|'vIZqn
visiting|приезжий|'vIzItIN
vocal|устный|'vqukql
volunteer|предлагать|,vOlqn'tIq
vow|давать обет, обещание|vau
wage|нанимать|weIdZ
wagon|тележка|'wxgqn
waiting|ожидание, ожидающий|'weItIN
wake|бодрствование, просыпаться|weIk
walking|гуляющий|'wO:kIN
walkout|забастовка|'wO:k'aut
want|недостаток|wOnt
warfare|война|'wO:fFq
warrant|ордер|'wOrqnt
warship|военный корабль|'wO:SIp
wartime|военное время|'wO:taIm
wash|мыть|wOS
waste|потери, расточать|weIst
wasteful|расточительный|'weIstful
watching|наблюдение|
water-colour|акварель|'wO:tq,kAlq
wave|развевать|weIv
weak|слабый|wi:k
weaken|ослаблять|'wi:kqn
wedding|свадьба|'wedIN
wedge|втискивать|wedZ
weigh|взвешивать|weI
wet|мокрый|wet
whatsoever|что бы ни|,wOtsqu'evq
whenever|когда бы ни|wen'evq
whereas|тогда как|wFqr'xz
whereby|чем, при помощи|wFq'baI
whip|хлыст, хлестать|wIp
whisper|шептать|'wIspq
wholly|полностью|'hqulI
wicked|злой|'wIkId
wicket|калитка|'wIkIt
wield|держать в руках|wi:ld
wildlife|зарница|'waIldlaIf
willing|готовый|'wIlIN
willingness|готовность|'wIlINnIs
wind|чуять|waInd
winding|изгиб|'waIndIN
windscreen|переднее стекло|
wine|вино|waIn
winning|победа, выигрывающий|'wInIN
wipe|вытирать|waIp
wire|проволока|'waIq
wisdom|мудрость|'wIzdqm
wise|мудрый|waIz
wishful|желаемый|'wISful
witch|ведьма|wItS
withdrawal|отзыв|wID'drO:ql
withhold|отказываться|wID'hquld
without|снаружи|wI'Daut
woefully|удручающе|
wolf|волк|wulf
wonder|чудо|'wAndq
woo|ухаживать|wu:
woodward|лесничий|'wudwqd
wool|шерсть|wul
workman|рабочий|'wq:kmqn
workplace|место работы|
workshop|мастерская|'wq:kSOp
worldwide|мировой|
worsen|ухудшать|'wq:sn
worship|поклоняться|'wq:SIp
worthy|достойный|'wq:DI
wreck|вызывать катастрофу|rek
wrecker|грабитель|'rekq
wright|мастер|
wrist|запястье|rIst
yacht|яхта|jOt
yearly|ежегодно|'jq:lI
yes|да|jes
yield|урожай|ji:ld
youngster|юноша|'jANstq
yourself|себя, себе|jO:'self
zinc|цинк|zINk
