Aids|СПИД|
American|американский|q'merIkqn
April|апрель|'eIpr(q)l
August|август|O:'gAst
British|британский|'brItIS
Christian|христианин, христианский|'krIstSqn
Christmas|Рождество|'krIsmqs
December|декабрь|dI'sembq
English|английский язык, английский|'INglIS
European|европейский|,juqrq'pIqn
February|февраль|'februqrI
French|французский|frentS
Friday|пятница|'fraIdI
Great Britain|Великобритания|
HP|лошадиная сила (от horse-power)|
I|я|aI
I'd|я бы (от I would, I should, I had)|aId
I'd like to...|я бы хотел(а)...|
I'll|я буду (от I shall)|
I'll drink to that|с этим я согласен|
I'm|я есть (от I am)|aIm
I've|я имею (от I have)|aIv
January|январь|'dZxnjuqrI
July|июль|dZu(:)'laI
June|июнь|dZu:n
March|март|mQ:tS
May|май|meI
Miss|мисс (незамужняя женщина, девушка)|mIs
Monday|понедельник|'mAndI
Mondays|понедельники (от Monday)|
November|ноябрь|nqu'vembq
O.K.|все в порядке, хорошо|
October|октябрь|Ok'tqubq
P.M.|после полудня|
Russia|Россия|'rASq
Russian|русский|'rASn
Saturday|суббота|'sxtqdI
September|сентябрь|sqp'tembq
Sunday|воскресенье|'sAndI
Sundays|воскресенья (от Sunday)|
TV|телевизор, телевидение|
Thursday|четверг|'Tq:zdI
Tuesday|вторник|'tju:zdI
VHS|видео для дома|
Wednesday|среда|'wenzdI
a|неопределенный артикль|eI
a few|несколько|
a great deal of|много|
ability|способность|q'bIlItI
able|умелый, способный|'eIbl
abolish|отменять, уничтожать|q'bOlIS
about|о|q'baut
above|над, выше, больше|q'bAv
abridgment|конспект|
abroad|за границу|q'brO:d
absence|отсутствие, неявка|'xbsqns
absolutely|совершенно|'xbsqlu:tlI
absorbent cotton|вата|
academy|академия|q'kxdqmI
accept|принимать|qk'sept
acceptable|приемлемый|qk'septqbl
accident|авария|'xksIdqnt
accompany|сопровождать|q'kAmpqnI
accompanying|сопровождающий|
according|по, согласно|q'kO:dIN
according to|согласно|
account|причина, счет|q'kaunt
accounts|отзывы, мнения (от account)|
accurate|точный, правильный|'xkjurIt
accuse|обвинять|q'kju:z
achievement|свершение|q'tSi:vmqnt
acknowledgment|признание, благодарность|
acquaintance|знакомство|q'kweIntqns
acquainted|знакомил, ознакомленный (от acquaint)|q'kweIntId
acre|акр|'eIkq
across|через, сквозь, на той стороне|q'krOs
act|действовать|xkt
acted|действовал (от act)|
active|активный, энергичный|'xktIv
actor|актер, артист|'xktq
actress|актриса|'xktrIs
actual|действительный|'xktSuql
actually|фактически, на самом деле|'xktSuqlI
ad|объявление|xd
add|складывать, прибавлять, добавлять|xd
additional|добавочный, дополнительный|q'dISqnl
address|адрес, обращение|q'dres
adhesive tape|пластырь (в рулоне)|
adjective|имя прилагательное|'xdZIktIv
adjust|приспособлять|q'dZAst
adjust|регулировать, приспосабливать|q'dZAst
administration|администрация, правительство|qd,mInIs'treIS(q)n
admirable|замечательный|'xdmqrqbl
admiration|восхищение|,xdmq'reIS(q)n
admire|любоваться, восхищаться|qd'maIq
admit|допускать, принимать, признавать|qd'mIt
admittance|впуск, доступ|qd'mItqns
ads|реклама|
adult|взрослый|'xdAlt
advantage|выгода, польза, преимущество|qd'vQ:ntIdZ
adventure|приключение|qd'ventSq
adverb|наречие|'xdvq:b
advertise|рекламировать|'xdvqtaIz
advertisement|объявление, реклама|qd'vq:tIsmqnt
advice|cовет|qd'vaIs
advise|советовать|qd'vaIz
affect|воздействовать|q'fekt
affirm|утверждать, подтверждать|q'fq:m
afford|позволить|q'fO:d
afraid|бояться|q'freId
after|после, за, о|'Q:ftq
afternoon|время после полудня|'Q:ftq'nu:n
again|снова|q'gen
against|против|q'genst
age|возраст|eIdZ
agent|агент, посредник|'eIdZqnt
ago|тому назад|q'gqu
agree|соглашаться|q'gri:
agreed|согласился (от agree)|
agreement|согласие, соглашение|q'gri:mqnt
agricultural|сельскохозяйственный|,xgrI'kAltSqrql
ahead|вперед, впереди|q'hed
aid|помощь|eId
aids|вспомогательные средства (от aid)|
aim|прицеливаться, стремиться|eIm
air|воздух|Fq
airconditioner|кондиционер|
aircraft|самолет|'FqkrQ:ft
airport|аэропорт|'FqpO:t
alarm|тревога|q'lQ:m
alas|увы! (выражение скорби, сожаления)|q'lxs
alcohol|алкоголь|'xlkqhOl
alike|похожий, подобный|q'laIk
alive|живой|q'laIv
all|все, весь|O:l
allergy|аллергия.|'xlqdZI
allow|разрешать, позволять|q'lau
almost|почти|'O:lmqust
alone|один, одинокий|q'lqun
along|вдоль, по|q'lON
aloud|вслух|q'laud
alphabet|алфавит|'xlfqbIt
already|уже|O:l'redI
also|тоже, также, к тому же|'O:lsqu
alterations|переделки, изменения (от alteration)|
alternative|альтернатива, альтернативный|O:l'tq:nqtIv
although|хотя, несмотря на|O:l'Dqu
altogether|совсем|,O:ltq'geDq
aluminum|алюминий|q'ljumInqm
alumnus|выпускник университета|q'lAmnqs
always|всегда|'O:lwqz
am|есть (от be)|xm
amaze|изумлять|q'meIz
amazed|удивлен (от amaze)|
ambassador|посол|xm'bxsqdq
ambulance|машина скорой помощи|'xmbjulqns
among|между, среди|q'mAN
amount|количество|q'maunt
amuse|развлекать, смешить|q'mju:z
amusement|развлечение|q'mju:zmqnt
an|неопределенный артикль (перед гласным звуком)|xn
analogy|сходство|q'nxlqdZI
analyse|разбирать, анализировать|'xnqlaIz
ancient|античный, старинный|'eInS(q)nt
and|и, а|xnd
anemia|анемия|
anger|гнев, злость|'xNgq
angle|точка зрения|'xNgl
angry|сердитый|'xNgrI
animal|животное|'xnImql
anniversary|годовщина|,xnI'vq:sqrI
announce|объявлять, сообщать|q'nauns
announcement|объявление|q'naunsmqnt
another|другой|q'nADq
answer|ответ, отвечать|'Q:nsq
antenna|антенна|xn'tenq
anxious|сильно желающий|'xNkSqs
any|сколько-нибудь, любой, никакой|'enI
anybody's|кого-либо (от anybody)|
anyone|кто-то, кто угодно|'enIwAn
anything|что-то, что угодно|'enITIN
anyway|во всяком случае|'enIweI
anywhere|где-нибудь|'enIwFq
apart|в стороне, отдельно, порознь|q'pQ:t
apartment|квартира|q'pQ:tmqnt
apartment hotel|гостиница квартирного типа|
apartment house|многоквартирный дом|
apiece|за штуку|q'pi:s
apologies|извинения (от apology)|
appear|появляться, казаться|q'pIq
appearance|(внешний) вид|q'pIqrqns
appetite|аппетит|'xpItaIt
appetizer|закуска|'xpItaIzq
apple|яблоко|'xpl
apples|яблоки (от apple)|
apply|обращаться, применять|q'plaI
appoint|назначать, нанимать на работу|q'pOInt
appointment|условленная встреча|q'pOIntmqnt
approach|приближаться, подходить ближе|q'prqutS
architect|архитектор|'Q:kItekt
ardent|заядлый|'Q:dqnt
are|есть (от be)|Q:
area|площадь, район|'FqrIq
argue|спорить|'Q:gju:
arguing|спорящий (от argue)|
argument|спор, аргумент|'Q:gjumqnt
arithmetic|арифметика|,xrIT'metIk
arm|рука (от плеча до кисти), подлокотник|Q:m
arms|оружие|Q:ms
army|армия|'Q:mI
around|вокруг, всюду, приблизительно|q'raund
arrange|привести в порядок, организовать|q'reIndZ
arrest|арестовать|q'rest
arrival|прибытие|q'raIvql
arrivals|прибытия (от arrival)|
arrive|прибывать|q'raIv
arrived|прибыли (от arrive)|
arriving|прибывающий|
art|искусство|Q:t
article|предмет, статья|'Q:tIkl
articles|предметы (от article)|
artificial|искусственный|,Q:tI'fIS(q)l
artist|художник|'Q:tIst
arts|художественный (от art)|
as|как, так, в то время как|xz
as far as|насколько|
as for|что касается|
ash|пепел, зола|xS
ashamed|пристыженный|q'SeImd
aside|в сторону|q'saId
ask|просить, спрашивать|Q:sk
asked|спрашивал, хотел (от ask)|
asking|спрашивающий, просящий|'Q:skIN
asleep|спящий|q'sli:p
assistant|помощник|q'sIstqnt
assume|принимать на себя, предполагать|q'sju:m
astonish|удивлять, изумлять|qs'tOnIS
astonished|изумлен (от astonish)|
astonishment|удивление, изумление|qs'tOnISmqnt
at|в, у|xt
at first|сначала|
at last|наконец, в конечном итоге|
at once|сразу, сейчас же|
at the moment|сейчас|
at times|иногда|
athlete|атлет|'xTli:t
attach|прикреплять, присоединять|q'txtS
attack|наступление, наступать|q'txk
attempt|попытка, пытаться|q'tempt
attend|посещать, присутствовать|q'tend
attention|внимание|q'tenS(q)n
attorney|адвокат (брит. вар.)|q'tq:nI
attract|привлекать|q'trxkt
aunt|тетя|Q:nt
author|автор|'O:Tq
authority|власть, авторитет|O:'TOrItI
automatic|автоматический|,O:tq'mxtIk
automatically|автоматически|,O:tq'mxtIk(q)lI
automobile|автомобиль|'O:tqmqubi:l
autumn|осень (брит. вар.)|'O:tqm
available|доступный|q'veIlqbl
avenue|широкая улица, проспект (в США)|'xvInju:
average|среднее число, средний|'xvqrIdZ
avoid|избегать|q'vOId
awake|будить, просыпаться|q'weIk
award|награда, награждать|q'wO:d
away|прочь|q'weI
awful|очень плохой, ужасный|'O:ful
awfully|крайне, очень|'O:fulI
awkward|неловкий|'O:kwqd
ax|топор|xks
baby|младенец, ребенок|'beIbI
back|обратно, назад, спина|bxk
back down|отказываться|
backpack|рюкзак|
bacon|бекон|'beIkqn
bad|плохой|bxd
badly|очень сильно|'bxdlI
bag|сумка|bxg
baggage|багаж|'bxgIdZ
bail|залог|beIl
bake|печь|beIk
balance|весы, равновесие|'bxlqns
balcony|балкон (в театре)|'bxlkqnI
bald|лысый|bO:ld
ball|мяч, шар|bO:l
ballet|балет|'bxleI
balloon|воздушный шар|bq'lu:n
baloney|чушь|bq'lqunI
bananas|бананы (от banana)|
band|лента|bxnd
band-aid|пластырь (бактерицидный)|
bandage|бинт|'bxndIdZ
bank|банк|bxNk
bar|бар|bQ:
barber|парикмахер|'bQ:bq
bare|голый, пустой (о помещении)|bFq
bargain|удачная покупка, сделка|'bQ:gIn
bargain sale|распродажа товаров по сниженным ценам|
bargains|удачные покупки (от bargain)|
barrel|баррель|'bxrql
bartender|бармен|'bQ:,tendq
base|основание, база|beIs
basement|подвал|'beIsmqnt
basic|основной|'beIsIk
basis|основа, база|'beIsIs
basket|корзина|'bQ:skIt
basketball|баскетбол|'bQ:skItbO:l
bath|ванна|bQ:T
bath-tub|ванна|'bQ:TtAb
bathe|купать, купаться|beID
bathing|купание, купальный|'beIDIN
bathrobe|домашний халат|'bQ:Trqub
bathroom|ванная|
baths|ванны (от bath)|
battery|аккумулятор|'bxtqrI
battle|битва, сражение|'bxtl
be|быть|bI
be at home (in)|владеть чем-либо|
be badly off|нуждаться|
be born|родиться|
be cashed up|иметь деньги при себе|
be laid up|лежать больным|
be located|находиться, располагаться|
be nuts about|быть страстным поклонником|
be out of sorts|плохо себя чувствовать|
beach|пляж|bi:tS
beak|клюв|bi:k
bean|фасоль|bi:n
bear|медведь|bFq
beard|борода|bIqd
beast|зверь|bi:st
beat|бить, колотить, побеждать|bi:t
beautiful|красивый|'bju:tqful
beauty|красота|'bju:tI
beauty parlor|парикмахерская|
became|становился, стал (от become)|bI'keIm
because|потому что|bI'kOz
become|становиться|bI'kAm
becomes|становится (от become)|
bed|кровать, постель|bed
bedridden|прикованный к постели болезнью|'bed,rId(n)
bedroom|спальня|'bedru(:)m
bee|пчела|bi:
beef|говядина|bi:f
been|быть (от be)|bi:n
beer|пиво|bIq
beet|свекла|bi:t
before|перед, до того как|bI'fO:
beg|просить, умолять|beg
began|начинал (от begin)|bI'gxn
begin|начинать(ся)|bI'gIn
begun|начатый (от begin)|bI'gAn
behave|вести себя|bI'heIv
behavior|поведение|bI'heIvjq
behind|позади|bI'haInd
being|будучи (от be)|'bi:IN
believe|верить, думать|bI'li:v
bell|колокол, колокольчик, звонок|bel
bell pepper|перец (стручковый)|
bell-hop|коридорный, посыльный|'belhOp
belly|живот|'belI
belong|принадлежать, относиться|bI'lON
below|внизу|bI'lqu
belt|пояс, ремень|belt
belts|ремни (от belt)|
bench|скамья|bentS
bend|изгиб|bend
bend|изгибать(ся), наклонять|bend
beneath|под, ниже, внизу|bI'ni:T
benefit|выгода, польза|'benIfIt
berries|ягоды (от berry)|
beside|мимо, не по существу|bI'saId
besides|кроме, кроме того, помимо|bI'saIdz
best|наилучший|best
bet|держать пари|bet
better|лучше|'betq
between|между|bI'twi:n
beware|остерегаться|bI'wFq
beyond|за, по ту сторону, позже, после, вдали|bI'jOnd
big|большой|bIg
bike|велосипед|baIk
bill|счет, законопроект|bIl
bind|связывать, привязывать|baInd
binder|папка для бумаг|'baIndq
biology|биология|baI'OlqdZI
bird|птица|bq:d
birth|рождение|bq:T
birthday|день рождения|'bq:TdeI
bit|немного|bIt
bite|кусать(ся)|baIt
bitter|горький|'bItq
black|черный|blxk
blade|лезвие|bleId
blame|считать виновным|bleIm
blank|бланк|blxNk
blanket|одеяло|'blxNkIt
blast|взрывать|blQ:st
blind|слепой|blaInd
block|глыба, квартал, блок|blOk
blockbuster|супербоевик|
blocks|кварталы (от block)|
blood|кровь|blAd
blossom|цветение, цвести|'blOsqm
blouse|блуза|blauz
blow|дуть (о ветре)|blqu
blue|синий|blu:
blues|уныние|blu:z
bluff|обман, блеф|blAf
board|питание|bO:d
boat|лодка, пароход|bqut
boating|катание на лодке|'bqutIN
bobby pin|заколка-"невидимка"|'bObIpIn
body|тело, туловище|'bOdI
boil|кипеть, кипятить, варить(ся)|bOIl
boiled|вареный|bOIld
bold|смелый|bquld
bomb|бомба, бомбить|bOm
bone|кость|bqun
bonnet|капот (брит. вар.)|'bOnIt
bonus|премия|'bqunqs
book|книга, заказывать|buk
bookcase|книжный шкаф|'bukkeIs
booked|заказал (от book)|bukt
booking office|касса (брит. вар.)|
bookkeeper|бухгалтер|'buk'ki:pq
books|книги (от book)|
bookshelf|книжная полка|'bukSelf
bookshop|книжный магазин (брит. вар.)|'bukSOp
bookstore|книжный магазин|'bukstO:
boot|ботинок, сапог|bu:t
booth|будка|bu:D
boots|ботинки, сапоги (от boot)|bu:ts
bore|скука, скучный|bO:
boring|скучный|'bO:rIN
borrow|занимать, заимствовать|'bOrqu
borrowed|брал в долг, взятый в долг (от borrow)|
bosom|загадочный|'buzqm
boss|хозяин|bOs
both|оба|bquT
bother|беспокоить|'bODq
bottle|бутылка|'bOtl
bottles|бутылки (от bottle)|
bought|купил, купленный (от buy)|bO:t
bouncer|вышибала|'baunsq
bouquet|букет|bu(:)'keI
bow|раскланиваться, кланяться|bau
bowl|чаша, ваза|bqul
bowling-alley|площадка для игры в шары (боулинг)|'bqulIN'xlI
box|ящик, коробка, будка|bOks
box office|имеющий кассовый успех|
boxes|ложи (от box)|
boxing|бокс|'bOksIN
boy|мальчик, юноша|bOI
bra|бюстгальтер|brQ:
bracelet|браслет|'breIslIt
brain|мозг|breIn
brake|тормоз|breIk
brakes|тормоза (от brake)|
brand|сорт, качество|brxnd
branсh|ветвь, филиал, отделение|
brass|установить|brQ:s
brave|храбрый|breIv
brawl|скандал|brO:l
bread|хлеб|bred
break|сообщать|breIk
break down|ломаться|
break out|избежать|
break up|разбиваться на куски|
breakfast|завтрак|'brekfqst
breath|дыхание|breT
breathe|дышать|bri:D
brewing|затевающий, надвигающийся (от brew)|'bru:IN
bribe|взятка|braIb
brick|кирпич|brIk
bridge|мост|brIdZ
brief|короткий|bri:f
bright|ясный|braIt
bring|приносить, приводить|brIN
bring up|воспитывать|
broadcast|передавать по радио или телевидению|'brO:dkQ:st
broil|жарить(ся) (на огне)|brOIl
broke|разоренный|brquk
bronze|бронзовый|brOnz
brooch|брошь|brqutS
brother|брат|'brADq
brought|принес, принесенный (от bring)|brO:t
brown|коричневый|braun
brush|щетка|brAS
buck|доллар|bAk
bucket|ведpo|'bAkIt
buffet|буфет (предмет мебели)|'bAfIt
bug|раздражать, надоедать|bAg
build|строить|bIld
building|здание|'bIldIN
built|строил, построенный (от build)|bIlt
bulb|лампочка (электрическая)|bAlb
bull|бык|bul
bump|удар, шишка, стукнуть(ся)|bAmp
bumper|амортизатор|'bAmpq
bumpy|ухабистая|'bAmpI
bureau|бюро, контора|bjuq'rqu
burn|жечь, гореть|bq:n
burst|заливаться|bq:st
bus|автобус|bAs
buses|автобусы (от bus)|
bush|куст|buS
business|дело, бизнес, деловой|'bIzInIs
business suit|деловой костюм|
busy|занятый|'bIzI
but|но, если (бы) не|bAt
butt in|вмешиваться|
butter|масло|'bAtq
butting in|вмешивающийся (от butt in)|
button|пуговица, кнопка|'bAtn
buttons|пуговицы (от button)|'bAtnz
buy|покупать|baI
buy|покупать, приобретать|baI
buying|покупка (от buy)|
buys|покупки (от buy)|
by|по, при, путем|baI
by all means|конечно|
by and large|в общем|
by no means|совсем не|
by the way|кстати|
bye-bye|до свидания, пока|'baI'baI
bеlоw|под, ниже|
bоther|беспокойство, беспокоить(ся)|
cab|такси|kxb
cabbage|капуста|'kxbIdZ
cabdriver|шофер|
cafe|кафе|'kxfeI
cage|клетка|keIdZ
cake|торт|keIk
calculate|вычислять, рассчитывать|'kxlkjuleIt
calendar|календарь|'kxlIndq
call|звонить, называть, вызов|kO:l
call a spade a spade|называть вещи своими именами|
called|звонил, названный (от call)|kO:ld
calling|звонящий, визитная (от call)|'kO:lIN
calm|успокаивать|kQ:m
came|пришел (от come)|keIm
came by|заработал (от came by)|
camera|фотоаппарат|'kxmqrq
campaign|кампания|kxm'peIn
can|банка; мочь (гл.)|kxn
can't|не мочь (от can not)|kQ:nt
can-opener|консервный нож|'kxn,qupnq
canal|канал|kq'nxl
cancel|отменять|'kxnsql
candies|конфеты (от candy)|
candle|свеча|'kxndl
candystore|кондитерский магазин|
cane|трость|keIn
cannot|не мочь|'kxnOt
cap|шапка|'kxp
capability|способность|,keIpq'bIlItI
capable|способный|'keIpqbl
capacity|вместимость|kq'pxsItI
capital|столица|'kxpItl
captain|капитан|'kxptIn
car|машина, вагон|kQ:
card|карточка|kQ:d
cardinal|количественный|'kQ:dInl
care|заботиться, переживать, иметь желание, осторожность|kFq
care for|желать, хотеть|
career|занятие, профессия, карьера|kq'rIq
careers|профессии (от career)|
careful|осторожный|'kFqful
careless|рассеянный|'kFqlIs
carfare|проездные (деньги)|'kQ:fFq
carnival|карнавал|'kQ:nIvql
carpet|ковер|'kQ:pIt
carrige|пассажирский вагон (брит. вар.)|
carrot|морковь|'kxrqt
carry|нести, носить, возить|'kxrI
carry on|продолжать|
carry out|выполнять|'kxrI 'aut
carry-on|ручная|
cartoon|кapикатура, мультипликационный фильм|kQ:'tu:n
case|сумка, судебное дело|keIs
cash|деньги|kxS
cashier|кассир (брит. вар.)|kq'SIq
casino|казино|kq'si:nqu
cassette|кассета|kq'set
castle|замок|'kQ:sl
cat|кот, кошка|kxt
catalog|каталог|'kxtqlOg
catalogue|каталог|'kxtqlOg
catch|поймать|kxtS
catch on|понимать|
cattle|рогатый скот|'kxtl
caught|попал(и) (разг.) (от catch)|kO:t
cauliflower|цветная капуста|'kOlIflauq
cause|причина, являться причиной, вызывать|kO:z
caution|осторожность|'kO:Sqn
cave|пещера|keIv
ceiling|потолок|'si:lIN
celebrate|праздновать|'selIbreIt
cent|цент|sent
center|центр|'sentq
centimeter|сантиметр|'sentI,mi:tq
central|центральный|'sentrql
century|столетие, век|'sentSurI
ceramic|керамический|sI'rxmIk
cereal|каша|'sIqrIql
ceremony|церемония|'serImqnI
certain|уверенный, некий, некоторый|'sq:tn
certainly|конечно|'sq:tnlI
certificate|справка|sq'tIfIkeIt
chain|цепь|tSeIn
chain-store|магазин с филиалами|
chair|стул, кафедра|tSFq
chambermaid|горничная|
champion|чемпион, победитель|'tSxmpjqn
chance|шанс|tSQ:ns
change|мелкие деньги, сдача, менять, пересаживаться|tSeIndZ
change purse|кошелек|
changed|поменял, изменил (от change)|
changes|меняется (от change)|
chap|парень, малый (разг.)|tSxp
chapter|глава (книги)|'tSxptq
character|характер, персонаж|'kxrIktq
charge|плата, стоимость, взимать плату|tSQ:dZ
charm|обаяние|tSQ:m
charmed|рад (от charm)|
charming|чудесный|'tSQ:mIN
chasing|уклоняющийся (от chase)|'tSeIsIN
chasing hares|уклоняющийся в сторону (от chase hares)|
chat|беседа, болтовня|tSxt
chatterbox|болтунья|'tSxtqbOks
cheap|дешевый|tSi:p
check in|сделать отметку о прибытии в гостиницу|
check out|рассчитаться за гостиницу|
check room|гардероб|
check-up|осмотр|
checked out|выписались (из гостиницы) (от check out)|
checkers|шашки|
checking-room|камера хранения (багажа)|
cheek|дерзость|tSi:k
cheer|одобрять, приветствовать|tSIq
cheer up|утешать|
cheered up|ободрил, развеселил (от cheer up)|
cheerful|веселый, счастливый|'tSIqful
cheerio|пока|'tSIqrI'qu
cheese|сыр|tSi:z
cheese cloth|марля|
chef|шеф-повар|Sef
chemist|аптекарь (брит. вар.)|'kemIst
chemistry|химия|'kemIstrI
cheque|банковский чек|tSek
cherries|вишни (от cherry)|
chess|шахматы|tSes
chest|грудная клетка, грудь|tSest
chicken|кура|'tSIkIn
chief|главный, начальник|tSi:f
child|ребенок|tSaIld
childhood|детство|'tSaIldhud
children|дети|'tSIldrqn
children's|детский (от children)|
chilly|прохладный, холодный|'tSIlI
chin|подбородок|tSIn
china|фарфор|'tSaInq
chip|стружка, щепка, хрустящий картофель (чип)|tSIp
chocolate|шоколад, шоколадный|'tSOkqlIt
choice|выбор|tSOIs
choose|выбирать|tSu:z
chorus|хор|'kO:rqs
chose|выбирал, выбрал (от choose)|tSquz
chosen|выбранный (от choose)|'tSquzn
church|церковь|tSq:tS
cigarette|сигарета|,sIgq'ret
cigarettes|сигареты (от cigarette)|
cinema|кино (брит. вар.)|'sInqmq
circle|круг, ярус|'sq:kl
circumstance|обстоятельство|'sq:kqmstqns
circus|цирк|'sq:kqs
citizen|гражданин, городской житель|'sItIzn
city|город|'sItI
civil|гражданский|'sIvl
civilization|цивилизация|,sIvIlaI'zeISqn
claim|требовать, утверждать, претендовать|kleIm
clap|хлопать|klxp
clarify|прояснить(ся)|'klxrIfaI
class|класс (брит. вар.)|klQ:s
classmate|одноклассник|'klQ:smeIt
classy|прекрасный|'klQ:sI
clean|чистить, чистый|kli:n
cleaned|чистил, (по)чищенный (от clean)|
cleaning|чистка|'kli:nIN
clear|ясный, очищать|klIq
cleared|рассчитался (от clear)|
clearly|ясно, отчетливо|'klIqlI
clever|умный|'klevq
climate|климат|'klaImIt
climb|взбираться|klaIm
clinic|больница, клиника|'klInIk
clip|скреплять|klIp
clock|часы (настольные, стенные)|klOk
close|близкий, близко, сближаться, закрывать|klqus
closed|закрыл, закрытый (от close)|klquzd
closer|поближе (от close)|
closet|стенной шкаф|'klOzIt
cloth|ткань|klOT
clothes|одежда|klquDz
clothing|одежда, обмундирование|'klquDIN
cloud|туча, облако|klaud
cloudy|облачный|'klaudI
club|клуб|klAb
clue|ход мыслей|klu:
co-ed|студентка (от coeducated)|'kqu'ed
coach|автобус, купе|kqutS
coal|уголь|kqul
coast|взморье|kqust
coat|пальто|kqut
cocktail|коктейль|'kOkteIl
cocktails|коктейли (от cocktail)|
cod|треска|kOd
coffee|кофе|'kOfI
coin|монета|kOIn
coincidence|совпадение|kqu'InsIdqns
coins|монеты (от coin)|
cold|холод, холодный, простуда|kquld
colder|холоднее (от cold)|
collar|воротник|'kOlq
colleague|коллега|'kOli:g
collect|коллекционировать|kq'lekt
collect letter|доплатное письмо|
collected|собрал (от collect)|kq'lektId
collection|коллекция|kq'lekSqn
college|колледж|'kOlIdZ
colony|колония|'kOlqnI
color|цвет|'kAlq
colors|цвета (от color)|
columns|колонки, графы (от column)|
comb|гребень, расческа, расчесывать (волосы)|kqum
come|приходить, приезжать|kAm
come around|соглашаться|
come back|возвращаться|
come down with|заболеть|
come in|входить|
come off|отрываться (о пуговице)|
come on|приходить, торопиться|
come out|выходить, появляться в продаже|
come up|подойти, отметить|
comfort|утешение, комфорт, утешать|'kAmfqt
comfortable|удобный|'kAmfqtqbl
comforter|одеяло (пуховое, стеганое)|'kAmfqtq
comics|комиксы|'kOmIks
coming|приход, приходящий (от come)|'kAmIN
comment|замечание, комментировать|'kOment
commercial bank|коммерческий банк|
commission|комиссионные|kq'mISqn
committee|комитет, комиссия|,kOmI'ti:
common|общий, обыкновенный|'kOmqn
compact|компактный|kqm'pxkt
company|компания|'kAmpqnI
comparative|сравнительный|kqm'pxrqtIv
compare|сравнивать|kqm'pFq
comparison|сравнение|kqm'pxrIsn
compartment|купе|kqm'pQ:tmqnt
compete|конкурировать, соревноваться|kqm'pi:t
competition|соревнование|,kOmpI'tISqn
complain|жаловаться|kqm'pleIn
complaint|жалоба, болезнь|kqm'pleInt
complete|полный, законченный, совершать, завершать|kqm'pli:t
completely|совершенно|kqm'pli:tlI
compliments|комплименты (от compliment)|
composer|композитор|kqm'pquzq
comprehension|понимание|,kOmprI'henSqn
comprehensive|обширный|,kOmprI'hensIv
computer|компьютер|kqm'pju:tq
concern|концерн, участие, забота, касаться|kqn'sq:n
concert|концерт|'kOnsq(:)t
conclude|заключать, решать|kqn'klu:d
condition|состояние, условие|kqn'dISqn
condole|соболезновать|kqn'dqul
conduct|поведение|'kOndAkt
conductor|проводник|kqn'dAktq
conference|совещание|'kOnfqrqns
confidence|уверенность, доверие|'kOnfIdqns
confirm|подтверждать, утверждать|kqn'fq:m
conflict|конфликт, противоречить|'kOnflIkt
confuse|приводить в замешательство, запутывать|kqn'fju:z
congratulate|поздравлять|kqn'grxtjuleIt
congratulations|поздравления (от congratulation)|
congress|конгресс, съезд|'kONgres
connect|соединять(ся), соединять (по телефону)|kq'nekt
cons|"против".|
conscience|совесть|'kOnSqns
conscious|сознающий, сознательный|-'kOnSqs
consider|рассматривать, принимать во внимание|kqn'sIdq
considerable|значительный|kqn'sIdqrqbl
considerably|значительно, сильно|kqn'sIdqrqblI
consist of|состоять из|
consists|состоит (от consist)|
consolation|утешение|,kOnsq'leISqn
constipated|запор (от constipate)|
consulate|консульство|'kOnsjulIt
contact|связаться|kqn'txkt
contacts|контакты (от contact)|
contain|содержать в себе|kqn'teIn
contemporary|современный|kqn'tempqrqrI
contents|содержимое, содержание|
contest|соревнование|'kOntest
continent|континент|'kOntInqnt
continental|континентальный|,kOntI'nentl
continue|продолжать|kqn'tInju(:)
contradict|противоречить|,kOntrq'dIkt
contradiction|противоречие|,kOntrq'dIkSqn
contrary|противоположность|kqn'trFqrI
contribution|содействие, вклад|,kOntrI'bju:Sqn
contributor|сотрудник|kqn'trIbjutq
control|контроль, управление|kqn'trqul
conveniences|удобства (от convenience)|
convenient|удобный|kqn'vi:njqnt
conversation|разговор, беседа|,kOnvq'seISqn
convert|обращать, превращать, конвертировать|'kOnvq:t
convertible|конвертируемый|kqn'vq:tqbl
cook|повар, готовить пищу, вариться|kuk
cookbook|поваренная книга|'kukbuk
cookie|домашнее печенье|'kukI
cool|прохладный|ku:l
cooler|холоднее (от cool)|'ku:lq
cooperate|сотрудничать|'ku:pqrIt
cooperation|сотрудничество|
cooperative|кооперативный|
coordinate|координировать|
cop|полицейский|kOp
cord|шнур|kO:d
corn|кукуруза|kO:n
corn-flakes|кукурузные хлопья|
corner|угол|'kO:nq
corns|мозоли (от corn)|
correct|правильный|kq'rekt
correctly|правильно|kq'rektlI
correspond|переписываться|,kOrIs'pOnd
corridor|коридор|'kOrIdO:
cost|стоить, стоил|kOst
cosy|уютный|'kquzI
cottage|летняя дача|'kOtIdZ
cotton|хлопок, хлопчатобумажный|'kOtn
couch|диван|kautS
cough|кашель|kOf
could|мог, могли (бы)|kud
couldn't help|не мог ничего сделать|
council|совет (организация)|'kaunsl
counsellor|адвокат|
count|подсчитывать|kaunt
count on|рассчитывать на, полагаться на|
counter|прилавок, окошко на почте (брит. вар.)|'kauntq-
country|страна|'kAntrI
couple|пара|'kApl
course|курс, блюдо|kO:s
court|корт|kO:t
courts|корты (от court)|
cousin|двоюродный брат|'kAzn
cover|предусматривать|'kAvq
cow|корова|kau
crack|попытка, проба|krxk
cracker|тонкое сухое печенье|'krxkq
crane|подъемный кран|kreIn
crash|авария, грохот, попасть в аварию|krxS
crawl|ползти, тащиться|krO:l
crazy|безумный, сумасшедший|'kreIzI
cream|крем|kri:m
cream of wheat|манная крупа|
credit|кредит|'kredIt
creek|ручей|kri:k
crew|экипаж|kru:
crime|преступление, преступность|kraIm
criminal|преступник, криминальный|'krImInl
crisis|кризис|'kraIsIs
cross|пересекать|krOs
crossing|переход|'krOsIN
crossroads|перекресток|
crowd|толпа, толпиться|kraud
crown|корона|kraun
crucial|критический, решающий|'kru:Sql
cruel|жестокий|kruql
cruller|жареный пирожок|
crummy|низкопробный, плохого качества|
cry|крик|kraI
crystal|хрусталь|'krIstl
cubic|кубический|'kju:bIk
cultural|культурный|'kAltSqrql
culture|культура|'kAltSq
cup|чашка, кубок|kAp
cupboard|посудный шкаф|'kApqd
cups|чашки (от cup)|
curds|творог|
cure|лечение, лечить|kjuq
curl|локон, завиток, виться|kq:l
currency|валюта|'kArqnsI
current|тeкущий, течение, электрический ток|'kArqnt
currently|настоящее время|
curtain|занавеска, занавес (в театре)|'kq:tn
curve|поворот|kq:v
custom-made|изготовленный на заказ|
customer|клиент, посетитель|'kAstqmq
customs|таможня|'kAstqmz
cut|прерывать|kAt
cut down|урезать, рубить|
cut off|отрезать|
cut out|оторвать, бросить (курить и т.п.)|
cute|милый, привлекательный|kju:t
cycle|цикл|'saIkl
cаbin|хижина, каюта|
cаmp|лагерь|
daily|ежедневный, ежедневная газета|'deIlI
damage|повреждение, повреждать|'dxmIdZ
damn|проклятие!|dxm
damp|влажный|dxmp
dance|танцевать|dQ:ns
dancing|танцы|'dQ:nsIN
danger|опасность|'deIndZq
dangerous|опасный|'deIndZrqs
danсe|танец, танцевать|
dare|осмеливаться|dFq
dark|темный|dQ:k
darkness|темнота|'dQ:knIs
data|данные|'deItq
date|дата|deIt
dates|даты (от date)|
daughter|дочь|'dO:tq
daughters|дочери|
day|день|deI
day coach|вагон с нумерованными местами для сидения в поезде|
day off|выходной день|
days|дни (от day)|
dead|полностью, точно|ded
dead end|тупик, безвыходное положение|
deaf|глухой|def
deal|сделка, иметь дело, заниматься бизнесом|di:l
dear|дорогой|dIq
debt|долг|det
debts|долги (от debt)|
decide|решать|dI'saId
decided|решил(и) (от decide)|dI'saIdId
decision|решение|dI'sIZqn
deck|палуба|dek
declaration|декларация|,deklq'reISqn
declare|декларировать|dI'klFq
decline|упадок, отклонять, ухудшаться|dI'klaIn
decrease|уменьшать(ся)|'di:kri:s
deduct|вычитать|dI'dAkt
deduction|вычитание|dI'dAkSqn
deep|глубокий, темный|di:p
defeat|поражение, побеждать, разбивать|dI'fi:t
defend|защищать|dI'fend
defense|защита|dI'fens
definite|определенный|'defInIt
degree|степень, ученая степень, градус|dI'gri:
degrees|градусы (от degree)|
delay|промедление, отсрочка|dI'leI
delegation|делегация|,delI'geISqn
delicatessen|гастрономический магазин|,delIkq'tesn
delicious|очень вкусный|dI'lISqs
delight|восторг, восхищать|dI'laIt
delighted|восхищался (от delight)|
delightful|восхитительный|dI'laItful
deliver|доставлять, вручать|dI'lIvq
delivery|доставка|dI'lIvqrI
demand|требование, запрос, требовать|dI'mQ:nd
dentist|дантист, зубной врач|'dentIst
department|отдел|dI'pQ:tmqnt
department store|универсам (брит. вар.)|dI'pQ:tmqnt'stO:
departments|отделы, отделения (от department)|
departure|отъезд|dI'pQ:tSq
departures|отлеты (от departure)|
depend|зависеть|dI'pend
depend on|полагаться, зависеть|
dependable|надежный|dI'pendqbl
deposit|взнос, вклад, залог, сдавать на хранение|dI'pOzIt
depot|станция (железнодорожная)|'depqu
depth|глубина|depT
describe|описывать|dIs'kraIb
desert|пустыня|dI'zq:t
design|проект, чертеж, проектировать|dI'zaIn
desire|желание, просьба, желать|dI'zaIq
desk|регистратура (в гостинице), настольный|desk
desk clerk|администратор (гостиницы)|
dessert|десерт|dI'zq:t
destination|место назначения|,destI'neISqn
destroy|уничтожать, разрушать|dIs'trOI
destruction|разрушение, уничтожение|dIs'trAkSqn
detail|подробность, деталь|'di:teIl
detective|детектив(ный)|dI'tektIv
determine|определять, решать(ся)|dI'tq:mIn
detour|объезд (на шоссе)|'di:tuq
develop|развивать(ся), проявлять|dI'velqp
development|развитие|dI'velqpmqnt
dial|диск набора (телефон.)|'daIql
dialogue|общение|'daIqlOg
dictaphone|диктофон|'dIktqfqun
dictionary|словарь|'dIkSqnrI
did|делал, действовал (от do)|dId
didn't|не делал (от did not)|
die|умирать|daI
diet|диета|'daIqt
differ|различаться|'dIfq
difference|разница, различие|'dIfrqns
different|другой, отличный от|'dIfrqnt
difficult|трудный|'dIfIkqlt
difficulties|трудности (от difficulty)|
difficulty|трудность|'dIfIkqltI
dig|копать, рыть|dIg
dime|дайм (10 центов)|daIm
dine|обедать|daIn
dining room|столовая|
dining-car|вагон-ресторан|'daInINkQ:
dining-room|столовая|'daInINrum
dinner|обед|'dInq
dinner suit|смокинг (брит. вар.)|
diploma|диплом|dI'plqumq
diplomat|дипломат|'dIplqmxt
diplomatic|дипломатический|,dIplq'mxtIk
direct|прямой, указывать путь, направлять|dI'rekt
direction|направление|dI'rekSqn
directly|прямо, непосредственно|dI'rektlI
directory|справочник|dI'rektqrI
dirt|грязь|dq:t
dirty|грязный|'dq:tI
disadvantage|неудобство|,dIsqd'vQ:ntIdZ
disagree|не соглашаться|,dIsq'gri:
disagreement|несогласие|,dIsq'gri:mqnt
disappear|исчезать|,dIsq'pIq
disappointed|разочарованный|,dIsq'pOIntId
disbelief|недоверие|'dIsbI'li:f
disc|диск|dIsk
discipline|дисциплина|'dIsIplIn
discord|раздоры, разногласие|'dIskO:d
discotheques|дискотеки (от discotheque)|
discount|скидка|'dIskaunt
discover|открывать, делать открытие|dIs'kAvq
discovery|открытие|dIs'kAvqrI
discs|диски (от disc)|
discuss|обсуждать|dIs'kAs
discussion|беседа|dIs'kASqn
disease|болезнь|dI'zi:z
disengaged|свободный|'dIsIn'geIdZd
disgrace|немилость, позор|dIs'greIs
disgraceful|позорный|dIs'greIsful
dish|тарелка, блюдо, кушанье|dIS
dishes|блюда (от dish)|
dislike|неприязнь, не любить|dIs'laIk
disliked|невзлюбил(и) (от dislike)|
disorder|беспорядок|dIs'O:dq
dispute|диспут, обсуждение, спорить|dIs'pju:t
distance|отдаленность, расстояние|'dIstqns
distinct|отчетливый, отличный (от других)|dIs'tINkt
distressed|огорчен (от distress)|dIs'trest
district|район|'dIstrIkt
disturb|беспокоить, расстраивать, нарушать|dIs'tq:b
disturbing|беспокойство (от disturb)|
dive|нырять|daIv
divide|делить, разделять(ся)|dI'vaId
division|(раз)деление, отдел, часть|dI'vIZqn
do|делать, действовать, вспомогательный глагол|du:
do away with|покончить|
do the dishes|мыть посуду|
do up|приводить в порядок, застегивать|
do without|обходиться (без чего-либо)|
doctor|доктор, врач|'dOktq
does|делать, действовать, вспомогательный глагол (от do)|
doesn't|не делать (от does not)|
dog|собака|dOg
doing|делающий, дело (от do)|
doll|кукла|dOl
dollar|доллар|'dOlq
dollars|доллары (от dollar)|
dominant|господствующий|'dOmInqnt
don't|не делаю, не действую (do not)|
done|сделанный (от do)|
donkey|осел|'dONkI
door|дверь|dO:
doorman|швейцар|
double|двойной, на двоих|'dAbl
doubt|сомнение, сомневаться|daut
dough|деньги|
down|внизу, вниз, глагольный послелог в некоторых сочетаниях|daun
downhill|ухудшающийся|
downstairs|внизу|,daun'steqz
downtown|деловая часть города|
downwards|вниз, книзу|
dozen|дюжина|'dAzn
drag|тащить(ся)|drxg
drain|стекать|dreIn
drama|драма|'drQ:mq
dramatic|драматический|drq'mxtIk
drank|(вы)пил (от drink)|drxNk
drapes|занавесь (портьера, штора)|
draughts|шашки (брит. вар.)|
draw|рисовать|drO:
draw up|составлять (документ)|
drawing|рисунок, чертеж|'drO:IN
drawn|нарисованный (от draw)|
dream|сон|dri:m
dreams|мечты (от dream)|
dress|платье, одеваться|dres
dress circle|бельэтаж|
dresser|комод (для одежды)|
dresses|платья (от dress)|
drew|рисовал (от draw)|dru:
dried|сушил (от dry)|draId
drill|сверлить|drIl
drink|напиток, пить|drINk
drinks|напитки (от drink)|
drive|водить машину, ехать на машине|draIv
driver|водитель|'draIvq
driver's|водительский (от driver)|
driving at|склоняющий к чему-либо (от drive at)|
drop|капелька, опускать|drOp
drop in|заходить|
drop off|заснуть|
drug|лекарство|drAg
druggist|аптекарь|
drugstore|аптека|'drAgstO:
drunk|выпитый, пьяный (от drink)|drANk
dry|сухой|draI
dry goods|мануфактура, галантерея|
duck|утка|dAk
due|должный, надлежащий, точно|dju:
due to|благодаря|
duet|дуэт|dju:'et
dull|тупой|dAl
dump|свалка|dAmp
duplex|дуплекс (двухэтажная квартира)|'dju:pleks
during|во время|'djuqrIN
dust|пыль, вытирать пыль, пылить|dAst
dusty|пыльный|
duty|долг, обязанность, пошлина|'dZu:tI
duty-free|беспошлинный|
dyed|окрашивал (от dye)|
dying|томиться желанием (от die) (разг.)|
each|каждый|i:tS
eager|стремящийся (к чему-либо)|'i:gq
ear|ухо, слух|Iq
earache|боль в ухе|
early|рано|'q:lI
earn|зарабатывать|q:n
earrings|серьги (от earring)|
earth|земля|q:T
easily|легко|'i:zIlI
east|восток, восточный|i:st
eastern|восточный|'i:stqn
easy|легко|'i:zI
eat|есть|i:t
eaten|съеденный (от eat)|'i:tn
economist|экономист|I(:)'kOnqmIst
edge|край, лезвие|edZ
edgeways|острием, краем (вперед)|'edZweIz
editions|издания (от edition)|
editor|редактор|'edItq
editorial|передовая статья|,edI'tO:rIql
educate|давать образование, воспитание|'edju(:)keIt
education|образование|,edju(:)'keISqn
effect|действие, эффект|I'fekt
effective|эффективный|I'fektIv
effort|усилие, попытка|'efqt
egg|яйцо|eg
eggplant|баклажан|
eight|восемь|eIt
eighteen|восемнадцать|,eI'ti:n
eighth|восьмой|eItT
eighty|восемьдесят|'eItI
either|или|'aIDq
elbow|локоть|'elbqu
elect|выбирать, избирать|I'lekt
election|выборы|I'lekSqn
electric|электрический|I'lektrIk
electric heater|электронагреватель|
electricity|электричество|Ilek'trIsItI
electronics|электроника|Ilek'trOnIks
elevator|лифт|'elIveItq
elevators|лифты (от elevator)|
eleven|одиннадцать|I'levn
else|еще|els
else|иначе|els
elsewhere|где-нибудь, в другом месте|'els'wFq
embassy|посольство|'embqsI
emblem|эмблема, символ|'emblqm
emergency|запасной|I'mq:dZqnsI
emigrant|эмигрант|'emIgrqnt
emigrate|эмигрировать|'emIgreIt
emotion|эмоция|I'mquSqn
employ|нанимать, использовать, применять|Im'plOI
employee|служащий|,emplOI'i:
employer|работодатель|Im'plOIq
employment|наем, служба, работа|Im'plOImqnt
empty|пустой|'emptI
enclose|вкладывать|In'klquz
end|конец|end
ending|окончание|'endIN
endive|цикорий|'endIv
endless|бесконечный|'endlIs
ends|концы (от end)|
enemy|враг, противник|'enImI
energy|энергия|'enqdZI
engaged|занятый (от engage)|In'geIdZd
engine|мотор|'endZIn
engineer|инженер|,endZI'nIq
enjoy|любить, получать удовольствие|In'dZOI
enjoyed|получил удовольствие (от enjoy)|
enjoyment|наслаждение, удовольствие|In'dZOImqnt
enough|достаточный|I'nAf
enquires|вопросы (от enquiry)|
enter|входить|'entq
enterprise|предприятие|'entqpraIz
enthusiasm|энтузиазм|In'Tju:zIxzm
entire|полный, целый|In'taIq
entirely|совершенно|In'taIqlI
entrance|вход|In'trQ:ns
entry|вход|'entrI
envelope|конверт|'envqlqup
epoch|эпоха|'i:pOk
equal|равный, равняться|'i:kwql
equipment|снаряжение, оборудование|I'kwIpmqnt
erase|стирать (резинкой)|I'reIz
eraser|резинка (канцелярская)|I'reIzq
erect|сооружать|I'rekt
error|ошибка|'erq
escape|бежать, избежать|Is'keIp
especially|особенно|Is'peSqlI
establish|установить|Is'txblIS
estimate|оценивать|'estImeIt
evacuation|эвакуация|I,vxkju'eISqn
even|четный, равный, даже|'i:vqn
evening|вечер|'i:vnIN
event|случай, событие, спортивное соревнование|I'vent
events|соревнования (от event)|
ever|когда-либо|'evq
every|каждый|'evrI
everybody|каждый, все|'evrIbOdI
everyone|каждый, все|'evrIwAn
everyplace|везде, повсюду|
everything|все|'evrITIN
evidence|основание, доказательство|'evIdqns
evolution|эволюция|,i:vq'lu:Sqn
exact|точный|Ig'zxkt
exactly|точно, именно|Ig'zxktlI
examination|экзамен, исследование|Ig,zxmI'neISqn
examine|досматривать|Ig'zxmIn
example|пример|Ig'zQ:mpl
exceed|превышать, превосходить|Ik'si:d
excellent|отличный|'eksqlqnt
except|кроме, исключая|Ik'sept
exchange|обмен, обменивать|Iks'tSeIndZ
excitement|возбуждение|Ik'saItmqnt
exciting|волнующий|Ik'saItIN
excursion|экскурсия|Iks'kq:Sqn
excursions|экскурсии (от excursion)|
excuse|извинять|Iks'kju:s
exercise|упражнение|'eksqsaIz
exhibition|выставка|,eksI'bISqn
exist|существовать, жить|Ig'zIst
exit|выход, выезд|'eksIt
expect|ожидать|Iks'pekt
expectation|ожидание|,ekspek'teISqn
expected|ожидал, полагал (от expect)|
expecting|ожидающий (от expect)|
expedition|экспедиция|,ekspI'dISqn
expenses|расходы (от expense)|
expensive|дорогой|Iks'pensIv
experience|опыт|Iks'pIqrIqns
experiment|эксперимент|Iks'perIment
expert|эксперт|'ekspq:t
experts|специалисты (от expert)|
explain|объяснять|Iks'pleIn
explanation|объяснение|,eksplq'neISqn
explicit|подробный, точный|Iks'plIsIt
explore|исследовать, изучать|Iks'plO:
export|экспорт, экспортировать|'ekspO:t
express|экспресс, выражать|Iks'pres
expressing|выражение (от express)|
expression|выражение|Iks'preSqn
extend|продлевать, оказывать|Iks'tend
external|наружный|eks'tq:nl
extra|экстренный выпуск газеты|'ekstrq-
extracted|удалил (зуб) (от extract)|
extremely|очень|Iks'tri:mlI
eye|глаз|aI
eye-opener|что-либо, открывающее человеку глаза|'aI,qupnq
eyebrow|бровь|'aIbrau
eyepencil|карандаш для век|
eyesight|зрение|'aIsaIt
face|лицо, стоять лицом к|feIs
faces|стоят лицом к (от face)|
facilities|удобства (коммунальные)|
fact|сущность, факт|fxkt
factor|фактор|'fxktq
factory|фабрика, завод|'fxktqrI
faculty|штат (служащих университета)|'fxkqltI
fail|провалить(ся), не удаваться|feIl
failure|неудача, провал|'feIljq
faint|терять сознание, слабый|feInt
fair|посредственный, средний|fFq
fairly|сносно|'fFqlI
fairy-tales|сказки (от fairy-tale)|
faith|вера, доверие|feIT
fall|падать, осень|fO:l
fall off|уменьшаться, снижаться|
fall through|провалиться, потерпеть неудачу|
fallen|упавший (от fall)|'fO:lqn
false|ложный|fO:ls
family|галерка, балкон|'fxmIlI
family name|фамилия|
famous|знаменитый|'feImqs
fancy|воображать, представлять себе|'fxnsI
fantastic|фантастический|fxn'txstIk
fantasy|фантазия|'fxntqsI
far|далеко|fQ:
fare|плата за проезд|fFq
farm|ферма, хозяйство|fQ:m
farmer|фермер|'fQ:mq
farming|сельское хозяйство|'fQ:mIN
fascinated|очаровал (от fascinate)|
fashion|мода|'fxSqn
fashionable|модный|'fxSnqbl
fast|быстрый|fQ:st
fasten|пристегнуть|'fQ:sn
faster|быстрее (от fast)|
fat|сало, жирный, толстый|fxt
father|отец|'fQ:Dq
fault|вина|fO:lt
favor|любезность|'feIvq
favorite|любимый|
fear|страх, боязнь|fIq
feather|перо|'feDq
feather in one's cap|достижение, успех|
feature|газетная статья|'fi:tSq
fed up|насыщенный, сытый по горло|
fee|гонорар|fi:
feed|кормить|fi:d
feel|(со)чувствовать|fi:l
feel bad|сожалеть|
feelers|пробы (от feeler)|
feeling|чувствующий (от feel)|'fi:lIN
feelings|чувства, страсти (от feeling)|
fell|упал (от fall)|fel
fell out|поссорились (от fall out)|
fell short of|не оправдал (надежду) (от fall short of)|
fell through|потерпел неудачу (от fall through)|
felt|чувствовал (от feel)|felt
female|женщина, женский|'fi:meIl
festival|фестиваль|'festqvl
fever|жар|'fi:vq
few|мало|fju:
fiction|художественная литература|'fIkSqn
field|поле|fi:ld
fifteen|пятнадцать|'fIf'ti:n
fifth|пятый|fIfT
fifths|пятых (от fifth)|
fifty|пятьдесят|'fIftI
fight|бороться|faIt
figure|цифра, думать|'fIgq
fill|заполнить, наполнить|fIl
filling|заполнение, наполнение, пломба (в зубе)|'fIlIN
filling station|бензоколонка (брит. вар.)|
film|фотопленка, фильм|fIlm
final|последний, окончательный|'faInl
finally|наконец|'faInqlI
find|найти, находить|faInd
find out|обнаруживать, узнавать|
fine|прекрасный|faIn
finger|палец|'fINgq
finish|конец, финиш, кончать|'fInIS
finish off|полностью заканчивать|
finish with|покончить (с чем-либо)|
fire|пожар|'faIq
firm|фирма, прочный, твердый|fq:m
firmly|твердо|
first|первый, сначала|fq:st
first name|имя|
firstly|во-первых|'fq:stlI
fish|рыба|fIS
fishing|рыбная ловля|'fISIN
fit|подходить, соответствовать, устраивать|fIt
fit as a fiddle|в добром здравии|
fits|подходит (от fit)|
five|пять|faIv
fix|наладить, починить; затруднительное положение|fIks
fixing|ремонт (от fix)|
flabbergasted|поражен, изумлен (от flabbergast)|
flag|флаг, знамя|flxg
flame|пламя|fleIm
flash|вспышка, вспыхивать, мчаться|flxS
flashed|пронесся (от flash)|
flashlight|фонарь (электрический)|
flat|спущенный|flxt
flew into|пришла (в ярость)|
flight|полет|flaIt
float|плавать (на поверхности)|flqut
floor|пол, этаж (брит. вар.)|flO:
floor lamp|торшер|
floored|поставил в тупик, сразил (от floor)|
flop|провал, неудача|flOp
flow|течь|flqu
flower|цветок|'flauq
flowers|цветы (от flower)|'flauqz
flown|улетевший (от fly)|flqun
flush it|чепуха|
fly|летать|flaI
fog|туман|fOg
folder|брошюра|'fquldq
follow|следить, слушать (за словами)|'fOlqu
following|следующий|'fOlquIN
fond|пристрастный, любящий|fOnd
food|пища, питание|fu:d
fool|дурак|fu:l
foot|нога, фут|fut
football|футбол, футбольный мяч|'futbO:l
footpath|тротуар (брит. вар.)|
footwear|обувь|'futwFq
for|для, за, на|fO:
forbid|запрещать|fq'bId
force|сила, войска, заставлять|fO:s
forecast|прогноз|'fO:kQ:st
forehead|лоб|'fOrId
foreign|иностранный|'fOrIn
foreigner|иностранец|'fOrInq
forest|лес|'fOrIst
forever|навсегда|fq'revq
forget|забыть|fq'get
forgive|прощать|fq'gIv
forgot|забыл (от forget)|fq'gOt
forgotten|забытый (от forget)|fq'gOtn
fork|вилка|fO:k
form|бланк, форма|fO:m
formal|официальный|'fO:mql
former|прежний, бывший|'fO:mq
fortunate|счастливый|'fO:tSnIt
fortunately|к счастью|
fortune|счастье|'fO:tSqn
forty|сорок|'fO:tI
forward|вперед, дальше|'fO:wqd
fought|боролся (от fight)|fO:t
found|нашел, найденный (от find)|faund
four|четыре|fO:
fourteen|четырнадцать|'fO:'ti:n
fourth|четвертый|fO:T
fox|лиса|fOks
fragile|хрупкий, ломкий|'frxdZaIl
frame|оправа|freIm
frames|оправы, рамки (от frame)|
frank|открытый, искренний|frxNk
frankfurters|сосиски (от frankfurter)|
frankly|откровенно|
free|свободный, бесплатный|fri:
freedom|свобода|'fri:dqm
freeze|замерзать, мерзнуть|fri:z
freight|груз, грузовой|freIt
freight-car|товарный вагон|
frequent|частый|'fri:kwqnt
frequently|часто|
fresh|свежий|freS
freshman|первокурсник|'freSmqn
fret|волноваться|fret
friend|друг|frend
friendly|дружеский|'frendlI
friends|друзья (от friend)|
friendship|дружба|'frendSIp
frighten|пугать|'fraItn
frightened|испуганный|'fraItnd
frog|лягушка|frOg
from|от, из|frOm
from scratch|с азов, с самого начала|
front|фасад, передняя часть, фронт|frAnt
front desk|портье (в отеле)|
frontier|граница|'frAntIq
frost|мороз|frOst
frosty|морозный|'frOstI
fruit|фрукты|fru:t
fruit-store|фруктовый магазин|
fruitful|плодотворный|'fru:tful
fry|жарить(ся)|fraI
fuel|топливо, горючее|fjuql
fulfil|исполнять|ful'fIl
full|полный|ful
full-time|полная ставка|
fun|веселье, смех|fAn
function|функция|'fAnNkSqn
fund|фонд|fAnd
fundamental|основной|,fAndq'mentl
funny|смешной|'fAnI
fur|мех, шерсть|fq:
fur-coat|шуба|
furniture|мебель|'fq:nItSq
furry|меховой, пушистый|'fq:rI
furs|меха (от fur)|
further|дальше (от far)|'fq:Dq
future|будущее, будущий|'fju:tSq
gain|получать, приобретать|geIn
gallery|галерея|'gxlqrI
gallon|галлон|'gxlqn
gallons|галлоны (от gallon)|
game|игра, матч|geIm
games|игры (от game)|
garage|гараж, ремонтная мастерская|'gxrQ:Z
garbage|мусор|'gQ:bIdZ
garden|сад|'gQ:dn
gardening|садоводство|'gQ:dnIN
gargling|полоскание (от gargle)|
gas|газ, бензин|gxs
gas station|бензоколонка|
gasmain|газопровод|
gate|ворота, проход|geIt
gatecrashers|незваные гости (от gatecrasher)|
gates|ворота (от gate)|
gather|собирать, понимать|'gxDq
gave|дал (от give)|geIv
gee|о господи!|'dZi:
gee whizz|ничего себе|'dZi:wIz
general|общий|'dZenqrql
general delivery|до востребования|
general store|универсам|
generally|обычно, вообще|'dZenqrqlI
generosity|великодушие|,dZenq'rOsItI
gentle|мягкий|'dZentl
gentleman|джентльмен|'dZentlmqn
gentlemen|джентльмены|
gently|мягко, осторожно|'dZentlI
genuine|подлинный, искренний|'dZenjuIn
geography|география|dZI'OgrqfI
gesture|жест|'dZestSq
get|получать, иметь, достигать, добраться|get
get along|удаваться, ладить|
get away|выйти из положения|
get back|возвращаться|
get by|обгонять|
get down|приносить, подносить|
get hold (of)|достать|
get into|вступать, входить|
get off|выходить|
get off the hook|выручить кого-либо|
get on|ходить, садиться (в машину и т.п.), стареть|
get on (with)|ладить|
get out|уходить|
get over|поправляться (после болезни)|
get through|пройти, закончить|
get up|вставать|
gets|надоедает, действует (разг.) (от get)|
getting|получение (от get)|
getting along|живущий, преуспевающий (от get along)|
getting on|преуспевающий (от get on)|
giddy|испытывающий головокружение|'gIdI
gift|подарок|gIft
girl|девочка, девушка|gq:l
give|давать, передавать|gIv
give back|возвращать|
give in|уступать|
give out|иссякать, кончаться|
give up|бросить|
given|данный (от give)|'gIvn
given name|имя|
glad|рад|glxd
gladly|с удовольствием|'glxdlI
glance|взгляд, взглянуть|glQ:ns
glass|стакан, бокал|glQ:s
glasses|очки (от glass)|
glitter|блеск, блестеть|'glItq
glorious|великолепный|'glO:rIqs
glory|слава|'glO:rI
glove|перчатка|glAv
gloves|перчатки (от glove)|
glue|клей, клеить|glu:
go|идти, попытка|gquz
go ahead|продолжайте|
go away|уходить, уезжать|
go back|возвращаться|
go mushrooming|ходить за грибами|
go on|продолжать, говорить и говорить|
go out|выходить, перегорать (о лампочке)|
goal|цель, ворота, гол (спорт.)|gqul
goblet|бокал|'gOblIt
god|бог, божество|gOd
goes|идет (от go)|
going|идущий (от go)|'gquIN
gold|золото, золотой|gquld
golden|золотистый|'gquldqn
golf|гольф|gOlf
gone up|возросший (от go up)|
good|хороший, добрый, добро, польза|gud
good heavens|боже мой!|
good-bye|до свидания|
goodness gracious|господи! (восклицание)|
goods|товары|gudz
gossip|сплетня, слухи|'gOsIp
got|получил, понял (от get)|gOt
got a rise out of|раздразнил(и) (от get a rise out of)|
got into|оказался (от get into)|
got out of hand|вышел из-под контроля (от get out of hand)|
got over|оправился (после болезни) (от get over)|
govern|управлять, править|'gAvqn
government|муниципалитет|'gAvnmqnt
governor|правитель, губернатор|'gAvqnq
grab|хватать|grxb
grade|класс|greId
grade school|начальная школа|'greId'sku:l
gradually|постепенно|'grxdjuqlI
graduated|окончил, окончивший учебное заведение (от graduate)|
grain|зерно|greIn
gram|грамм|grxm
grand|великолепный|grxnd
grandchild|внук, внучка|'grxntSaIld
granddaughter|внучка|'grxn,dO:tq
grandfather|дедушка|'grxnd,fQ:Dq
grandmother|бабушка|'grxn,mADq
grandparents|бабушка и дедушка|'grxn,pFqrqnts
grandson|внук|'grxnsAn
grant|разрешать|grQ:nt
grape|виноград|greIp
grapefruit|грейпфрут|
grapes|виноград|
grass|трава|grQ:s
grateful|благодарный|'greItful
gratitude|благодарность|'grxtItju:d
gray|серый|greI
great|большой, прекрасный|greIt
greatcoat|шинель|'greItkqut
greatly|очень|'greItlI
green|зеленый|gri:n
greet|приветствовать|gri:t
greeting|поздравление|'gri:tIN
greetings|приветствия (от greeting)|
grew|рос (от grow)|gru:
grief|горе, печаль|gri:f
grind|долгая и упорная работа|graInd
grip|контроль|grIp
groceries|запасы пищи (домашние)|
grocery|бакалейно-гастрономический магазин|'grqusqrI
ground|нижний, первый (брит. вар.)|graund
group|группа, группировать(ся)|gru:p
grow|расти|grqu
grow up|взрослеть|
grown|выращенный (от grow)|grqun
grown-up|взрослый|'grqunAp
growth|рост, увеличение|grquT
guarantee|гарантия|,gxrqn'ti:
guess|считать, полагать|ges
guest|гость|gest
guide|путеводитель|gaId
guided|руководимый (от guide)|
guilty|виновный|'gIltI
guitar|гитара|gI'tQ:
gulf|залив|gAlf
gum|жевательная резинка, клей|gAm
gun|ружье, пушка|gAn
guy|парень|gaI
gym|гимнастический зал|dZIm
haberdashery|предметы мужского туалета|'hxbqdxSqrI
habit|привычка, обыкновение, обычай|'hxbIt
had|иметь, вспомогательный глагол (от have)|hxd
hail|приветствовать|heIl
hailed|сыпался град (от hail)|
hair|волосы|hFq
hair-cut|стрижка|
hair-dye|краситель для волос|
hairdo|прическа|'hFqdu:
hairdresser's|парикмахерская (брит.вар.)|
hairspray|лак для волос|
half|половина|hQ:f
halfpenny|полпенни|'heIpnI
hall|коридор, зал|hO:l
hallo|привет|hq'lqu
ham|ветчина|hxm
hamburger|гамбургер|'hxmbq:gq
hammer|молоток|'hxmq
hand|рука|hxnd
hand-set|телефонная трубка|
handbag|дамская сумка|'hxndbxg
handkerchief|носовой платок|'hxNkqtSIf
handle|ручка, pyкоятка, трогать, справляться|'hxndl
hands|руки (от hand)|
handsome|красивый|'hxnsqm
handy|полезный, умелый|'hxndI
hang|вешать|hxN
happen|случаться, происходить|'hxpqn
happened|случилось (от happen)|
happiness|счастье|'hxpInIs
happy|счастливый|'hxpI
harbor|гавань|'hQ:bq
hard|с трудом, тяжело, упорно|hQ:d
hard up|сильно нуждающийся (в деньгах)|'hQ:d'Ap
harder|упорнее, больше (от hard)|
hardware store|магазин скобяных товаров|
harm|вред, ущерб, вредить, повреждать|hQ:m
harmful|вредный|'hQ:mful
harmless|безвредный|'hQ:mlIs
harvest|урожай|'hQ:vIst
has|имеет (от have)|hxz
hasn't|не имеет (от has not)|'hxznt
hat|шляпа|hxt
hat-check girl|гардеробщица|'hxttSek'gq:l
hatibut|палтус|
have|иметь, вспомогательный глагол, заставить|hxv
have one's picture taken|заказать фотографии, сфотографироваться|
haven't|не имею (от have not)|
having|имеющий, обладающий (от have)|
he|он|hi:-
he'll|он будет (от he will)|hi:l
head|голова|hed
headache|головная боль|'hedeIk
heading|направляющийся (от head)|'hedIN
headline|заголовок|'hedlaIn
headmaster|директор (брит. вар.)|
headphones|наушники (от headphone)|
heads|головы (от head)|
health|здоровье|helT
healthy|здоровый|'helTI
hear|слышать|hIq
heard|слушал, услышанный (от hear)|hq:d
heart|сердце|hQ:t
heartily|сердечно|'hQ:tIlI
hearty|большой, сильный|'hQ:tI
heat|жар, зной, жара, топить, нагревать(ся)|hi:t
heating|отопление|'hi:tIN
heaven's|божье|
heavy|тяжелый|'hevI
hectare|гектар|'hektQ:
heel|пятка, каблук|hi:l
heeled|имеющий каблук (от heel)|hi:ld
height|высота, рост|haIt
held|держал (от hold)|held
helicopter|вертолет|'helIkOptq
hell|черт, ад, страшно|hel
hello|привет|'he'lqu
helmet|шлем|'helmIt
help|помощь, помогать|help
helpful|полезный|'helpful
helping|порция|'helpIN
helpless|бесполезный, неумелый|'helplIs
hen|курица|hen
her|ее, ей|hq:
here|здесь, вот|hIq
hero|герой|'hIqrqu
hesitate|колебаться|'hezIteIt
hesitation|колебание, сомнение|,hezI'teISqn
hi|привет!|haI
hi-fi|высшего класса|'haI'faI
hide|прятать, скрывать|haId
high|высокий|haI
high-rise|высотный|'haIraIz
highly|очень, в высшей степени|'haIlI
highway|шоссе|'haIweI
highways|шоссейные дороги (от highway)|
hiking|поход (от hike)|
hill|подъем|hIl
him|его, ему|hIm
himself|себя, себе, сам|hIm'self
hint|намек|hInt
hip|бедро|hIp
hippodrome|ипподром|'hIpqdrqum
hire|взять напрокат|'haIq
his|его|hIz
historical|исторический|hIs'tOrIkql
history|история|'hIstqrI
hit|успех, удача, попадать в цель|hIt
hobbies|любимые занятия (от hobby)|
hobby|хобби|'hObI
hockey|хоккей|'hOkI
hold|держать(ся), выдерживать|hquld
hole|дыра, отверстие, яма, нора|hqul
holiday|отпуск|'hOlqdI
holidays|каникулы (от holiday)|
home|дом, домашний|hqum
homemade|самодельный|
honest|честный, искренний|'OnIst
honestly|честно|'OnIstlI
honey|мед|'hAnI
honor|честь|'Onq
hood|капот|hud
hook|крючок, цеплять крючком, ловить (рыбу)|huk
hope|надеяться|hqup
hopes|надеется (от hope)|
horizon|горизонт|hq'raIzn
horrible|ужасный|'hOrqbl
horse|лошадь, конь|hO:s
horse radish|хрен|
hospitable|гостеприимный|'hOspItqbl
hospital|больница|'hOspItl
hospitality|гостеприимство|,hOspI'txlItI
host|хозяин|hqust
hostile|враждебный|'hOstaIl
hot|горячий, жаркий|hOt
hot dog|бутерброд с горячей сосиской|'hOt'dOg
hotel|гостиница|hqu'tel
hotter|жарче (от hot)|
hour|час|'auq
hourly|ежечасно, ежечасный|'auqlI
hours|часы (от hour)|
house|дом, внутренний|haus
household|хозяйственный|'haushquld
housewarming|празднование новоселья|
housewife|домашняя хозяйка|'hauswaIf
housework|работа по дому|'hauswq:k
how|как|hau
how come|как же это?|
however|однако|hau'evq
hug|объятия, обнимать|hAg
huge|огромный|hju:dZ
human|человеческий|'hju:mqn
humid|влажный|'hju:mId
humidity|влажность|hju(:)'mIdItI
humor|юмор|'hju:mq
hunch|предчувствие, интуиция|hAntS
hundred|сто|'hAndrqd
hung|повесил, повешенный (от hang)|hAN
hungry|голодный|'hANgrI
hunky-dory|первоклассный|,hANkI'dO:rI
hunt|искать, разыскивать, охотиться|hAnt
hunter|охотник|'hAntq
hunting|охота|'hAntIN
hurry|спешить|'hArI
hurt|рана, болеть, причинить боль|hq:t
hurts|болеет, причиняет боль (от hurt)|
husband|муж|'hAzbqnd
husband's|мужнино (от husband)|
hut|хижина|hAt
ice|лед|aIs
ice cream|мороженое|
icebox|холодильник (морозильник)|
icicle|сосулька|'aIsIkl
icy|ледяной|'aIsI
idea|мысль|aI'dIq
ideal|идеальный|aI'dIql
identical|тот же самый, идентичный|aI'dentIkql
ideology|идеология|,aIdI'OlqdZI
if|если|If
ignore|игнорировать|Ig'nO:
ill|больной (брит. вар.)|Il
illness|болезнь|'IlnIs
illustrated|иллюстрированный|
image|образ|'ImIdZ
imagine|думать, предполагать|I'mxdZIn
immediately|немедленно|I'mi:djqtlI
immigrant|иммигрант|'ImIgrqnt
immigrate|иммигрировать|'ImIgreIt
import|импорт, ввоз|'ImpO:t
importance|важность|Im'pO:tqns
important|важный|Im'pO:tqnt
impossible|невозможный|Im'pOsqbl
impress|производить впечатление|Im'pres
impression|впечатление|Im'preSqn
impressionists|импрессионисты (от impressionist)|
improve|улучшать|Im'pru:v
improvement|улучшение, усовершенствование|Im'pru:vmqnt
impulse|толчок, импульс|'ImpAls
in|в, на|In
in back of|сзади, позади|
in order to|чтобы|
inability|неспособность|,Inq'bIlItI
inch|дюйм|IntS
incident|случай, инцидент|'InsIdqnt
incidentally|случайно, между прочим|,InsI'dentlI
inclose|окружать, заключать|In'klquz
include|включать, заключать|In'klu:d
income|доход|'InkAm
incorporated (Inc.)|объединенный, зарегистрированный (организация)|
increase|возрастание, возрастать|'Inkri:s
incredible|невероятно|In'kredqbl
indeed|в самом деле|In'di:d
independence|независимость|,IndI'pendqns
independent|независимый|,IndI'pendqnt
indigestion|расстройство желудка|,IndI'dZestSqn
individual|личный, индивидуальный|,IndI'vIdjuql
indoors|внутри|'In'dO:z
industrial|промышленный|In'dAstrIql
industry|промышленность|'IndqstrI
inequality|неравенство, различие|,InI(:)'kwOlItI
inexpensive|дешевый|,InIks'pensIv
infinitive|неопределенная форма глагола|In'fInItIv
influence|влияние, влиять|'Influqns
inform|сообщать|In'fO:m
informal|неофициальный|In'fO:ml
information|информация, справочное бюро|,Infq'meISqn
initial|инициал|I'nISql
initials|инициалы (от initial)|
initiate|близкий|I'nISIeIt
ink|чернила|INk
inland|внутренний|'Inlqnd
inquire|спрашивать, справляться|In'kwaIq
inquiry|справка, вопрос|In'kwaIqrI
insane|безумный|In'seIn
insect|насекомое|'Insekt
inside|внутри|'In'saId
insnare|заманивать|
inspection|досмотр|In'spekSqn
install|устанавливать, укреплять, закреплять|In'stO:l
installments|очередные взносы (при рассрочке) (от installment)|
instant|мгновение, немедленный, текущий|'Instqnt
instantly|тотчас, немедленно|'InstqntlI
instead (of)|взамен, вместо|
institute|институт|'InstItju:t
instructor|преподаватель (высшего учебного заведения)|In'strAktq
instrument|инструмент, прибор|'Instrumqnt
insurance|страхование|In'Suqrqns
insure|страховать(ся)|In'Suq
insured|гарантированный, ценный (от insure)|
intellect|интеллект|'IntIlekt
intellectual|интеллектуальный, интеллигент|,IntI'lektjuql
intelligentsia|интеллигенция|In,telI'dZentsIq
intend|намереваться|In'tend
interest|интересовать, интерес|'IntrIst
interested|заинтересованный, интересующийся (от interest)|'IntrIstId
interesting|интересный|'IntrIstIN
interfere|мешать, вмешиваться|,Intq'fIq
interjection|восклицание|,Intq(:)'dZekSqn
interjections|восклицания (от interjection)|
intermission|антракт|,Intq(:)'mISqn
international|международный|,Intq(:)'nxSqnl
interpret|толковать, переводить (устно)|In'tq:prIt
interpreter|переводчик|In'tq:prItq
interrogative|вопросительный|,Intq'rOgqtIv
interrupt|прерывать, мешать|,Intq'rApt
interrupting|прерывание, прерывающий (от interrupt)|
interruption|перерыв, помеха, препятствие|,Intq'rApSqn
intersection|перекресток|,Intq(:)'sekSqn
interval|антракт|'Intqvql
intervals|интервалы (от interval)|
interview|интервью, иметь беседу|'Intqvju:
into|в|'Intu
introduce|предстaвлять, знакомить|,Intrq'dju:s
introduction|(официальное) представление|,Intrq'dAkSqn
invalid|недействительный|,Invq'li:d
invent|выдумывать, изобретать|In'vent
invention|выдумка, изобретение|In'venSqn
invisible|невидимый|In'vIzqbl
invitation|приглашение|,InvI'teISqn
invitations|приглашения (от invitation)|
invite|приглашать|In'vaIt
invited|пригласил, приглашенный (от invite)|
iron|железо, утюг, утюжить, гладить|'aIqn
iron out|сглаживать|
irritation|раздражение|,IrI'teISqn
is|есть (от be)|Iz
island|остров|'aIlqnd
isn't|не является (от is not)|'Iznt
isolate|изолировать|'aIsqleIt
issue|выпуск, издание, выпускать|'ISu:
it|это, он, она (для предметов и животных)|It
it depends|трудно сказать|
it's|это есть (от it is)|Its
it's high time|давно пора|
its|его, ее (от it)|Its
itself|себя, самого себя, сам, сама|It'self
itеm|пункт, вопрос|
jack|деньги|dZxk
jacket|куртка|'dZxkIt
jam|варенье, джем|dZxm
jar|банка|dZQ:
jazz|джаз|dZxz
jealous|ревнивый, завистливый|'dZelqs
jeans|джинсы|dZi:nz
jelly-roll|булка с вареньем|
jewel|драгоценный камень|'dZu:ql
jewellery|ювелирный|'dZu:qlrI
job|работа|dZqub
jobs|работы (от job)|
jogging along|двигающийся (от jog along)|
join|войти в компанию, объединиться|dZOIn
joke|шутка|dZquk
joking|подшучивающий (от joke)|
jolly|весело|'dZOlI
journal|журнал, ведомости, дневник|'dZq:nl
journalist|журналист|'dZq:nqlIst
journey|поездка, путешествие|'dZq:nI
joy|радость|dZOI
judge|судья, судить, решать|'dZAdZ
judgment|мнение, взгляд|'dZAdZmqnt
juice|сок|dZu:s
jump|прыжок, прыгать|dZAmp
jumper|джемпер|'dZAmpq
jumping|прыжок (от jump)|
junior|младший, третьекурсник|'dZu:njq
just|только, всего лишь, именно|dZAst
keen|сильно желающий, любящий|ki:n
keep|(со)держать, сохранять|ki:p
keep off|держаться в стороне|
keep on|продолжать|
keep tabs on|следить (за кем-либо)|
keeping|имеющий, живущий (от keep)|'ki:pIN
keeps|держится (от keep)|
kept|заставил, держал (от keep)|kept
kerosene|керосин|'kerqsi:n
kettle|чайник|'ketl
key|ключ, ведущий|ki:
keу|ключ|
kick|пинать, ударять ногой|kIk
kicked up|поднял (шум) (от kick up)|
kid|ребенок, обманывать|kId
kidding|высмеивающий|
kidneys|почки (анатом.)|
kids|дети (от kid)|
kill|убивать|kIl
kilogram|килограмм|'kIlqugrxm
kilometre|километр|'kIlqu,mi:tq
kilometres|километры (от kilometre)|
kind|добрый, вид, род|kaInd
kindly|любезно|'kaIndlI
kindness|доброта|'kaIndnIs
king|король|kIN
kiss|поцелуй, целовать|kIs
kit|набор инструментов|kIt
kitchen|кухня|'kItSIn
knee|колено|ni:
knew|знал (от know)|nju:
knife|нож|naIf
knitted|трикотажный|'nItId
knock|стук, ударять|nOk
knocked down with a feather|ошеломил (от knock down with a feather)|
knot|узел|nOt
know|знать|nqu
knowing|знание, знающий|'nquIN
knowledge|знание|'nOlIdZ
known|узнанный (от know)|nqun
label|ярлык, этикетка|'leIbl
labor|труд, работа|'leIbq
lack|недостаток, отсутствие|lxk
ladies|дамы (от lady)|'leIdIz
lady|дама, леди|'leIdI
laid|положил (от lay)|leId
laid an egg|потерпел неудачу (от lay an egg)|
laid off|уволен, отдыхал (от lay off)|
lake|озеро|leIk
lamb|ягненок|lxm
lamp|лампа|lxmp
land|земля, страна, приземляться, заканчивать|lxnd
landing|приземление, посадка (о самолете)|'lxndIN
language|язык|'lxNgwIdZ
languages|языки (от language)|
large|большой|lQ:dZ
largely|в основном|'lQ:dZlI
larger|больше (от large)|
lark|забава|lQ:k
last|прошлый, последний, длиться|lQ:st
lasting|продолжительный|'lQ:stIN
late|поздно, запоздалый|leIt
lately|недавно|'leItlI
later|позже|'leItq
latest|последний (от late)|'leItIst
laugh|смех|lQ:f
laughed|смеялся (от laugh)|
laughing|смех, смеющийся|'lQ:fIN
laughter|смех, хохот|'lQ:ftq
laundry|прачечная, стирка|'lO:ndrI
law|право|lO:
lawyer|юрист, поверенный|'lO:jq
lay|класть, положить|leI
lay away|сэкономить, сохранить|
lay off|отдыхать|
lay out|раскладывать|
lazy|ленивый|'leIzI
lead|вести|li:d
leader|лидер|'li:dq
leading|ведущий|'li:dIN
leaf|лист|li:f
learn|узнать, учиться|lq:n
learner|учащийся|'lq:nq
learning|изучение (от learn)|'lq:nIN
least|малейшая степень|li:st
leather|кожа, кожаный|'leDq
leave|оставлять, покидать, уезжать|li:v
leave alone|оставлять в покое, не беспокоить|
leave behind|забыть, оставить|
leave for|переезжать|
leave off|остановиться|
leave out|пропустить|
leaving|уезжающий (от leave)|
lecture|лекция|'lektSq
left|левый, налево|left
left|оставил (от leave)|left
left-luggage office|камера хранения (брит. вар.)|
leg|нога|leg
legal|юридический, правовой, законный|'li:gql
legend|легенда|'ledZqnd
leisure|досуг|'leZq
lemon|лимон|'lemqn
lemonade|лимонад|,lemq'neId
lend|дать в долг|lend
length|длина|leNT
lent|одолжил (от lend)|lent
less|меньше|les
lesson|урок|'lesn
let|позволять, давать, разрешать|let
let alone|уже не говоря о|
let down|подводить, разочаровать|
let in|позволить войти|
let off|отпустить|
let on|рассказать|
let out|позволить уйти|
let up|остановиться, прекратиться|
letter|письмо|'letq
letters|письма (от letter)|
level|уровень|'levl
liberal|либеральный|'lIbqrql
liberty|свобода|'lIbqtI
library|библиотека|'laIbrqrI
license|лицензия|'laIsqns
lid|крышка|lId
lie|ложь, лгать; лежать|laI
lie down|ложиться|
life|жизнь|laIf
lift|поднимать, лифт (брит. вар.)|lIft
light|светлый, легкий|laIt
lighter|зажигалка|'laItq
lightning|молния|'laItnIN
lights|фары (от light)|laIts
like|любить, нравиться, похожий, подобный|laIk
liked|понравился (от like)|
likely|вероятно|'laIklI
likes|любит (от like)|
limit|предел, граница|'lImIt
line|линия, очередь|laIn
line up|стоять в очереди|
linen|белье|'lInIn
lining|подкладка|'laInIN
lion|лев|'laIqn
lip|дерзость|lIp
lip-stick|помада|
liquid|жидкость|'lIkwId
liquor|ликер, спиртной напиток|'lIkq
list|список|lIst
listen|слушать|'lIsn
liter|литр|'li:tq
literate|грамотный|'lItqrIt
literature|литература|'lItqrItSq
litre|литр|'li:tq
litter|сор, мусор|'lItq
little|мало, маленький, немного|'lItl
live|жить|laIv
live on|выжить|
lively|деятельный, оживленный|'laIvlI
liver|печенка|'lIvq
liverwurst|ливерная колбаса|
living|живой, средства к существованию, жизнь|'lIvIN
living room|гостиная|
load|груз, грузить|lqud
loaf|булка|lquf
loan|заем, давать взаймы|lqun
lobby|фойе, холл|'lObI
local|местный|'lqukql
lock|закрывать на замок|lOk
lodgings|жилье (сдаваемое на время)|
logic|логика|'lOdZIk
loneliness|одиночество|
lonely|одинокий|'lqunlI
long|длинный, долгий, долго|lON
long-distance call|междугородный телефонный разговор|
longer|длиннее (от long)|'lONgq
look|смотреть, выглядеть, взгляд|luk
look after|заботиться|
look for|искать|
look forward to|ожидать с нетерпением|
look in on|заглянуть (к кому-либо)|
look out|быть внимательным|
look over|просматривать, проверять|
look up|справляться, искать, поднимать глаза|
looking|смотрящий (от look)|
looking for|ищущий (от look for)|
looking forward to|ожидающий (от look forward to)|
looks|выглядит (от look)|
loose|свободный, неточный|lu:s
lorry|грузовик (брит. вар.)|'lOrI
lose|терять|lu:z
loser|проигравший|'lu:zq
loses|теряет (от lose)|
loss|потеря, убыток|lOs
lost|потерял, потерянный (от lose)|lOst
lost-and-found|бюро находок|
lot|много|lOt
loud|громкий, громко|laud
loudly|громко|'laudlI
love|любовь, привет, находить удовольствие|lAv
lovely|прекрасный, восхитительный|'lAvlI
lover|любовник, возлюбленный|'lAvq
low|низкий|lqu
lower|понижать, опускать|'lquq
luck|удача, везение|lAk
luck's|удачи (от luck)|
luckily|к счастью|'lAkIlI
lucky|счастливый, удачный|'lAkI
lucky dog|счастливец|
luggage|багаж (брит. вар.)|'lAgIdZ
lunch|второй завтрак, обед|lAntS
machine|машина, механизм|mq'Si:n
mad|рассерженный|mxd
madam|госпожа|'mxdqm
made|делал, сделанный (от make)|meId
magazine|журнал|,mxgq'zi:n
magazines|журналы (от magazine)|
magic|магия, волшебство|'mxdZIk
magnificent|чудесный|mxg'nIfIsnt
maiden|девичья|'meIdn
mail|почта, отправлять (по почте)|meIl
mailbox|почтовый ящик|'meIlbOks
mailman|почтальон|'meIlmxn
main|основной, главный|meIn
mainly|главным образом|'meInlI
maintain|поддерживать, сохранять, содержать|meIn'teIn
major|больший, старший, профилирующий предмет (в университете)|'meIdZq
make|делать, производить|meIk
make of|думать (о чем-либо)|
make off with|удрать, сбежать|
make out|выписывать|
make up|выдумывать|
make-up|косметика|'meIkAp
makes|делает (от make)|
makeup|косметика|
making|делающий, совершающий (от make)|'meIkIN
male|мужчина, мужской|meIl
mall|торговый центр|mO:l
man|мужчина, человек|mxn
manage|справляться, суметь сделать|'mxnIdZ
managed|удалось (от manage)|'mxnIdZd
manager|управляющий|'mxnIdZq
manages|ухитряется (от manage)|
mandatory|обязательный|'mxndqtqrI
mankind|человечество|mxn'kaInd
manner|манера, сорт, род|'mxnq
manners|манеры, умение держать себя (от manner)|
manual|ручной, учебник|'mxnjuql
many|много (с исчисляемыми существительными)|'menI
map|карта|mxp
margarine|маргарин|,mQ:dZq'ri:n
mark|известность|mQ:k
market|рынок|'mQ:kIt
marriage|свадьба|'mxrIdZ
marriage certificate|свидетельство о браке|
married|женатый, замужняя|'mxrId
marry|выходить замуж, жениться|'mxrI
mascara|тушь|mxs'kQ:rq
mashed potatoes|картофельное пюре|'mxStpq'teItquz
mass|масса, множество|mxs
massage|массаж|'mxsQ:Z
massive|огромный|'mxsIv
matches|спички (от match)|
material|сырье, материал, ткань|mq'tIqrIql
mathematics|математика|,mxTI'mxtIks
matter|вопрос, дело|'mxtq
matters|дела, сущность (от matter)|
maximum|максимальный|'mxksImqm
may|мочь, иметь возможность|meI
maybe|мoжет быть|'meIbi:
mayor|мэр|mFq
me|мне, меня|mi:
meager|недостаточный|'mi:gq
meal|еда|mi:l
meals|еда (от meal)|
mean|означать, иметь в виду|mi:n
meaning|смысл|'mi:nIN
means|средство, способ|mi:nz
meant|имел в виду (от mean)|ment
meanwhile|между тем|'mi:n'waIl
measure|мера, измерять|'meZq
measurement|измерение, размеры|'meZqmqnt
measuring|измерения (от measure)|
meat|мясо, мясной|mi:t
meat grinder|мясорубка|
mechanic|механик|mI'kxnIk
medal|медаль|'medl
medical|медицинский|'medIkql
medicine|медицина, лекарство|'medsIn
medium|средний|'mi:djqm
meet|встречать(ся), знакомиться|mi:t
meeting|встреча|'mi:tIN
meetings|встречи (от meeting)|
melody|мелодия|'melqdI
melon|дыня|'melqn
melt|таять, плавить|melt
member|член|'membq
members|члены (от member)|
memorize|заучивать наизусть, запоминать|'memqraIz
memory|память, воспоминание|'memqrI
men|мужчины (от man)|men
mend|чинить, ремонтировать|mend
mended|починил (от mend)|
mention|благодарность, упоминать|'menSqn
mentioned|упомянул (от mention)|
menu|меню|'menju:
merit|заслуга, достоинство|'merIt
merry|веселый, радостный|'merI
mess|беспорядок, путаница|mes
message|сообщение, передавать|'mesIdZ
met|встречались, встреченный (от meet)|met
metal|металл, металлический|'metl
meter|метр|'mi:tq
metered|платный (от meter)|
method|метод, способ|'meTqd
metre|метр|'mi:tq
midday|полдень|'mIddeI
middle|средний|'mIdl
middle initial|инициалы второго имени|
middling|сносный (о здоровье)|'mIdlIN
midnight|полночь|'mIdnaIt
might|можно, возможно (от may)|maIt
mighty|могущественный, мощный, очень|'maItI
mild|мягкий|maIld
mildness|мягкость|'maIldnIs
mile|миля|maIl
mileage|пробег, число пройденных миль|'maIlIdZ
miles|мили (от mile)|
military|военный|'mIlItqrI
milk|молоко|mIlk
mill|милл (1/10 цента) (тысячная часть доллара)|mIl
milliliter|миллилитр|
millimeter|миллиметр|
million|миллион|'mIljqn
mince|смягчать, выражать в мягкой форме|mIns
mind|память, мнение, помнить, возражать|maInd
mine|мой|maIn
mineral|минерал, минеральный|'mInqrql
minimum|минимальный|'mInImqm
minister|министр|'mInIstq
ministry|министерство|'mInIstrI
minor|мелкий|'maInq
minus|минус|'maInqs
minute|минута|maI'nju:t
miracle|чудо|'mIrqkl
miracles|чудеса (от miracle)|
mirror|зеркало|'mIrq
misfortune|несчастье, неудача|mIs'fO:tSqn
mislead|ввести в заблуждение|mIs'li:d
miss|мисс, госпожа|mIs
missed|пропустил (от miss)|
misses (Mrs)|миссис, госпожа|
missile|ракета|'mIsaIl
missus|жена|'mIsIz
mistake|ошибка, ошибаться|mIs'teIk
mistaken|ошибающийся (от mistake)|mIs'teIkqn
mister (Mr)|мистер, господин|
misunderstand|неправильно понимать|'mIsAndq'stxnd
misunderstanding|непонимание|'mIsAndq'stxndIN
misunderstood|не понял (от misunderstand)|'mIsAndq'stud
mix|смешивать|mIks
mixture|микстура|'mIkstSq
mobile|подвижный, мобильный|'mqubaIl
moderate|умеренный, средний|'mOdqreIt
modern|временный, новый|'mOdqn
modest|скромный, умеренный|'mOdIst
mold|характер|mquld
molt|линька (животных)|mqult
moment|минута, момент|'mqumqnt
moments|моменты, минуты (от moment)|
money|деньги|'mAnI
monkey|обезьяна|'mANkI
month|месяц|mAnT
monthly|ежемесячный|'mAnTlI
months|месяцы (от month)|
monument|памятник|'mOnjumqnt
monuments|памятники (от monument)|
mood|настроение|mu:d
moon|луна|mu:n
moonlight|подрабатывать (нелегальное совместительство)|'mu:nlaIt
moot|спорный|mu:t
moral|моральный, нравственный|'mOrql
more|еще, больше|mO:
morning|утро|'mO:nIN
mortal|смертный|'mO:tl
most|больше всего, самый|mqust
mostly|чаще всего|'mqustlI
motels|мотели (от motel)|
mother|мать|'mADq
motion|движение|'mquSqn
motive|мотив, побуждение|'mqutIv
motor|мотор, двигатель|'mqutq
motorist|водитель|'mqutqrIst
mountain|гора|'mauntIn
mouse|мышь|maus
mouth|рот|mauT
mouthpiece|микрофон|'mauTpi:s
move|двигать(ся), переезжать|mu:v
move along|проходить, проезжать|
move in|въезжать|
move out|выезжать|
movement|движение|'mu:vmqnt
movie|кино, фильм|'mu:vI
movies|кино, фильмы (от movie)|
much|много (с неисчисляемыми существительными)|mAtS
mud|грязь|mAd
muddy|грязный|'mAdI
multiplication|умножение|,mAltIplI'keISqn
multiply|умножать|'mAltIplaI
museum|музей|mju(:)'zIqm
mushroom|гриб|'mASrum
mushrooms|грибы (от mushroom)|
music|музыка|'mju:zIk
musical|музыкальный|'mju:zIkql
must|должен, надо|mAst
mustache|усы|mqs'tQ:S
mustard|горчица|'mAstqd
mutton|баранина|'mAtn
mutual|взаимный, общий, совместный|'mju:tjuql
my|мой, моя, мое, мои|maI
myself|себя, меня самого, себе, сам|maI'self
mystery|тайна|'mIstqrI
myth|миф|mIT
mаtсh|матч, состязание, спичка, подходить|
nail|ноготь, гвоздь|neIl
nail polish|лак для ногтей|
nails|ногти (от nail)|
naked|голый, обнаженный|'neIkId
name|имя, фамилия, называть|neIm
namely|а именно, то есть|'neImlI
napkin|салфетка|'nxpkIn
narrated|рассказывающий, повествовательный (от narrate)|
narrow|узкий|'nxrqu
nasty|плохой|'nQ:stI
nation|страна|'neISqn
national|национальный|'nxSqnl
nationality|национальность|,nxSq'nxlItI
native|родной|'neItIv
natural|естественный, природный|'nxtSrql
naturally|естественно, конечно|'nxtSrqlI
nature|природа|'neItSq
navigate|плавать, управлять (самолетом)|'nxvIgeIt
navy|военно-морской флот|'neIvI
near|около, у|nIq
nearby|близкий, близко|'nIqbaI
nearest|ближайший (от near)|
nearly|почти|'nIqlI
neat|чистый, опрятный|ni:t
necessary|необходимый|'nesIsqrI
neck|шея|nek
necklace|ожерелье|'neklIs
need|нуждаться в, надо, нужда|ni:d
needle|игла|'ni:dl
needles|иголки (от needle)|
needs|нуждается (от need)|ni:dz
neglect|пренебрегать|nI'glekt
negotiation|переговоры|nI,gquSI'eISqn
neighbor|сосед, соседка|'neIbq
neighborhood|соседство|
neighboring|соседний|
neighbors|соседи (от neighbor)|
neither|также не, тоже не|'naIDq
nephew|племянник|'nevju(:)
nerve|нерв|nq:v
nerves|нервы (от nerve)|
nervous|нервный|'nq:vqs
nest|гнездо|nest
net|сеть|net
neutral|нейтральный|'nju:trql
never|никогда|'nevq
new|новый|nju:
news|новости, известия|nju:z
newspaper|газета|'nju:s,peIpq
newspaper stall|газетный киоск (брит. вар.)|
newspapers|газеты (от newspaper)|
newsstand|газетный киоск|
next|следующий|nekst
nice|хороший, чудесный, приятный|naIs
nice kettle of fish|хорошенькое дело|
nicer|лучше (от nice)|
nickel|никл (монета в 5 центов)|'nIkl
niece|племянница|ni:s
night|ночь|naIt
nights|ночи (от night)|
nine|девять|naIn
nineteen|девятнадцать|'naIn'ti:n
ninety|девяносто|'naIntI
ninth|девятый|naInT
no|нет, не, никакой|nquz
no one|никто|'nquwAn
no place|никуда, некуда|
nobody|никто|'nqubqdI
nodding|шапочное (от noddy)|
noise|шум|nOIz
noisy|шумный|'nOIzI
non-committal|уклончивый|'nOnkq'mItl
non-rush hour|обычное время|
non-smoking|некурящий|
none|никто, никакой|nAn
nonsense|вздор, бессмыслица|'nOnsqns
noon|полдень|nu:n
nor|и не, также не|nO:-
normal|нормальный, обычный|'nO:mql
normally|обычно|'nO:mqlI
north|север|nO:T
northern|северный|'nO:Dqn
nose|нос|nquz
not|не|nOt
not so dusty|неплохо|
note|записка, расписка|nqut
notebook|тетрадь|'nqutbuk
notes|записки (от note)|
nothing|ничто, ничего|'nATIN
notice|объявление, внимание, замечать|'nqutIs
notify|сообщать|'nqutIfaI
notions|необходимые мелкие предметы (нитки, булавки и пр.)|
noun|существительное|naun
novel|роман|'nOvql
novels|романы (от novel)|
now|сейчас|nau
nowadays|в наше время|'nauqdeIz
nuisance|досада|'nju:sns
number|номер|'nAmbq
numeral|числовой|'nju:mqrql
numerals|числительные (от numeral)|
nursery|детская|'nq:sqrI
nut|орех|nAt
nuts|орехи (от nut)|
nylon|нейлон, нейлоновый|'naIlqn
nаtive|родной, природный, местный|
o'clock|часов|q'klOk
oak|дуб|quk
oatmeal|овсяная каша|'qutmi:l
obey|слушаться, повиноваться|q'beI
object|предмет, вещь, цель, возражать|'ObdZIkt
objection|возражение, протест|qb'dZekSqn
objective|объективный|qb'dZektIv
obligation|обязательство|,OblI'geISqn
obliged|обязан, признателен (от oblige)|
observe|наблюдать, замечать|qb'zq:v
obstacle|препятствие, помеха|'Obstqkl
obstruct|загораживать|qb'strAkt
obtain|достигать, добывать, приобретать|qb'teIn
obvious|ясный, очевидный|'ObvIqs
obviously|очевидно|
occupation|занятие|,Okju'peISqn
occupied|занятый, занял (от occupy)|
occupy|занимать|'OkjupaI
occur|иметь место, случаться|q'kq:
ocean|океан|'quSqn
odd|странный|Od
odds|разногласие|Odz
of|предлог родительного падежа (кого?, чего?)|Ov
of course|конечно|
off|прочь, от|Of
offer|предложение, предлагать|'Ofq
offered|предлагал, предложенный (от offer)|
office|офис, контора, служебный|'OfIs
officer|должностное лицо, служащий|'OfIsq
official|официальный, деловой|q'fISql
often|часто|'Ofn
ogre|ужасный человек|'qugq
oil|масло|OIl
ointment|мазь|'OIntmqnt
okay (O.K.)|все в порядке|
old|старый|quld
old-fashioned|старомодный|
omelette|омлет|'OmlII
omit|упускать, пренебрегать|q'mIt
on|на, в, вперед, дальше|On
on the street|на улице|
once|однажды|wAns
one|один, некто, кто-то|wAn
one-way|односторонний (в одну сторону)|
onion|лук|'Anjqn
only|только|'qunlI
open|открывать|'qupqn
open-and-shut|очевидный|
openly|открыто, откровенно|'qupnlI
opera|опера|'Opqrq
operation|операция|,Opq'reISqn
operator|оператор|'OpqreItq
opinion|мнение|q'pInjqn
opponent|противник|q'pqunqnt
opposite|противоположный, напротив|'OpqzIt
optometrist|окулист|
or|или|O:
orange|апельсин, оранжевый|'OrIndZ
oranges|апельсины (от orange)|
orchestra|партер|'O:kIstrq
order|порядок, приказ, заказ, заказывать|'O:dq
ordinal|порядковый|'O:dInl
ordinary|обычный|'O:dnrI
organization|организация|,O:gqnaI'zeISqn
organize|организовать|'O:gqnaIz
organizm|организм|
origin|источник, начало, происхождение|'OrIdZIn
original|оригинал, первоначальный|q'rIdZqnl
other|другой|'ADq
ought|должен (модальный глагол)|O:T
ounce|унция|auns
our|наш|'auq
ourselves|себя, себе, сами|,auq'selvz
out|вне, без, за, наружный|aut-
outcome|результат|'autkAm
outdated|устарелый|aut'deItId
outdoor|на свежем воздухе|'autdO:
outdoors|на улице, на открытом воздухе|'aut'dO:z
outside|вне|'aut'saId
over|через, над, сверх, заканчивать|'quvq-
overcast|покрытый облаками|'quvqkQ:st
overcoat|пальто|'quvqkqut
overdrawn|преувеличенный, превышенный (от overdraw)|'quvq'drO:n
overhearing|нечаянно услышанный (от overhear)|
overly|слишком|'quvqlI
overnight|всю ночь|'quvq'naIt
overseas|заграничный, международный|'quvq'si:z
overtime|сверхурочные|'quvqtaIm
owe|быть должным|qu
own|иметь, владеть, свой, собственный|qun
owned|владел (от own)|
owner|владелец, собственник|'qunq
oxygen|кислород|'OksIdZqn
oyster|устрица|'OIstq
oреn|открытый, открывать|
oрроsе|быть против, противостоять|
pack|стопка, пачка, упаковывать|pxk
package|сверток, посылка|'pxkIdZ
package holiday|комплексная туристическая поездка|
packet|пачка|'pxkIt
paddle|ракетка (для игры в настольный теннис)|'pxdl
page|страница|peIdZ
paid|платил, оплаченный (от pay)|peId
pail|ведро|peIl
pain|боль, страдание|peIn
painful|болезненный|'peInful
pains|боли, страдания (от pain)|
paint|красить, краска|peInt
painted|красил, окрашенный (от paint)|'peIntId
painter|художник|'peIntq
painting|живопись|'peIntIN
pair|пара|pFq
pal|приятель, старина|pxl
palace|дворец|'pxlIs
pale|бледный, тусклый|peIl
pan|кастрюля|pxn
panorama|панорама|,pxnq'rQ:mq
pants|брюки|pxnts
panty hose|колготки|
paper|бумага|'peIpq
parade|парад|pq'reId
parallel|параллельный|'pxrqlel
parcel|пакет, посылка|'pQ:sl
pardon|извинение|'pQ:dn
parents|родители|
park|ставить на стоянку|pQ:k
parking|стоянка|'pQ:kIN
part|часть, доля, роль, делить, расставаться, расходиться|pQ:t
part-time|неполный рабочий день|
particular|частность, особенность|pq'tIkjulq
parties|вечеринки (от party)|
parting|прощание|'pQ:tIN
partner|партнер|'pQ:tnq
parts|части (от part)|
party|вечеринка, группа|'pQ:tI
pass|передавать, проходить , пропуск|pQ:s
passed|прошла (от pass)|
passenger|пассажирский|'pxsIndZq
passes|проходит (от pass)|
passing|прохождение, проходящий|'pQ:sIN
passive|пассивный|'pxsIv
passport|паспорт|'pQ:spO:t
past|мимо, после, за|pQ:st
paste|паста, мастика, склеивать|peIst
patent leather|лакированный|'peItqnt'leDq
path|тропа, путь|pQ:T
patient|пациент, терпеливый|'peISqnt
patronymic|отчество|,pxtrq'nImIk
pattern|пример, образец|'pxtqn
pause|пауза, остановка|pO:z
pavement|проезжая часть дороги, мостовая|'peIvmqnt
pay|платить, зарплата, обращать|peI
pay а visit|наносить визит|
pay-roll|платежная ведомость|
payday|день зарплаты|'peIdeI
paying|нанесение (визита) (от pay)|'peIIN
payment|плата|'peImqnt
pea|горох|pi:
peace|мир, покой|pi:s
peaceful|мирный, спокойный|'pi:sful
peaches|персики (от peach)|
pearl|жемчуг, жемчужный|pq:l
pears|груши (от pear)|
peculliar|особый, странный|
peek|заглядывать|pi:k
pen|ручка|pen
pence|пенс|pens
pencil|карандаш|'pensl
penetrate|проникать|'penItreIt
penny|пенни|'penI
pension|пенсия|'penSqn
pensioner|пенсионер|'penSqnq
people|люди|'pi:pl
pepper|перец|'pepq
peppermints|мятные конфеты (от peppermint)|
per|в|pq:
percent|процент|pq'sqnt
perfectly|отлично|'pq:fIktlI
perform|делать|pq'fO:m
performance|представление|pq'fO:mqns
perfume|духи|'pq:fju:m
perfumery|парфюмерия|pq'fju:mqrI
perhaps|возможно|pq'hxps
period|период|'pIqrIqd
permanent|постоянный|'pq:mqnqnt
permit|пропуск, разрешение, разрешать|'pq:mIt
person|человек, личность|'pq:sn
person-to-person|определенное лицо|
personal|личный|'pq:snl
perspective|перспектива, перспективный|pq'spektIv
persuade|убеждать|pq'sweId
pet|домашнее животное|pet
petrol|бензин (брит. вар.)|'petrql
petty|малозначительный, мелкий|'petI
phone|телефон, звонить по телефону|fqun
phoney|фальшивый|'fqunI
photo|фотография|'fqutqu
photographer|фотограф|fq'tOgrqfq
photography|фотография|fq'tOgrqfI
phrase|фраза|freIz
physical|физический, телесный|'fIzIkql
physics|физика|'fIzIks
pianist|пианист|'pIqnIst
piano|рояль, пианино|'pjQ:nqu
pick|собирать|pIk
pick out|выбирать|
pick up|поднимать, схватывать|
picked up|набирал скорость (от pick up)|
picnic|пикник|'pIknIk
picture|картина, изображение, рисовать, описывать|'pIktSq
pictures|картины, кино (от picture)|
pie|пирог|paI
piece|кусок, часть|pi:s
pieces|части, места (от piece)|
pig|свинья|pIg
pigeon|голубь|'pIdZIn
pile|куча, стопка, складывать в кучу|paIl
pill|таблетка|pIl
pillar box|почтовый ящик (брит. вар.)|
pillow|подушка|'pIlqu
pills|таблетки (от pill)|
pilot|пилот, лоцман|'paIlqt
pin|булавка, скреплять|pIn
pineapple|ананас|'paIn,xpl
pink|розовый|pINk
pins|значки (от pin)|
pint|кружка, пинта|paInt
pipe|трубка|paIp
pitcher|кувшин|'pItSq
pity|жалость|'pItI
pizza|пицца|
pizza parlor|пиццерия|
place|место|pleIs
places|места (от place)|
plain|равнина, ясный, простой|pleIn
plain|ясный, очевидный|pleIn
plain as a pikestaff|очевидный, ясный, как день|
plan|план, планировать|plxn
plane|самолет|pleIn
planet|планета|'plxnIt
planning|планирующий, планирование (от plan)|
plans|планы (от plan)|
plant|растение, сажать|plQ:nt
plastic|пластик, пластичный, пластический|'plxstIk
plate|тарелка, блюдо|pleIt
plates|тарелки (от plate)|
platform|платформа (брит. вар.)|'plxtfO:m
play|играть, игра|pleI
player|плейер|'pleIq
plays|играет (от play)|
pleasant|приятный|'pleznt
please|пожалуйста (только в просьбе)|pli:z
pleasure|удовольствие|'pleZq
plenty|изобилие, множество|'plentI
plenty of|много|
plow|плуг, пахать|plau
plug|пробка, штепсель|plAg
plums|сливы (от plum)|
plural|множественное число, многочисленный|'pluqrql
plus|плюс|plAs
pocket|карман|'pOkIt
pocket-knife|перочинный нож|'pOkItnaIf
poem|стихотворение|'pquIm
poems|стихи (от poem)|
poet|поэт|'pquIt
point|суть, тема, вопрос|pOInt
point out|указывать|
poison|яд|'pOIzn
polar|полярный|'pqulq
pole|полюс, мачта|pqul
police|полиция|pq'li:s
policeman|полицейский|pq'li:smqn
policy|политика|'pOlIsI
polish|лак|'pqulIS
polite|вежливый|pq'laIt
political|политический|pq'lItIkql
politician|политик, политический деятель|,pOlI'tISqn
politics|политика|'pOlItIks
pollution|загрязнение|pq'lu:Sqn
pool|лужа, бассейн|pu:l
poor|бедный, скверный|puq
poorly|неважно|'puqlI
popcorn|каленые зерна кукурузы|'pOpkO:n
popular|популярный|'pOpjulq
population|население|,pOpju'leISqn
pork|свинина|pO:k
port|порт|pO:t
portable|переносной|'pO:tqbl
porter|носильщик (брит. вар.)|'pO:tq
portrait|портрет|'pO:trIt
position|положение|pq'zISqn
positive|положительный, уверенный|'pOzqtIv
possibility|возможность|,pOsq'bIlItI
possible|возможный|'pOsqbl
possibly|возможно, может быть|'pOsqblI
post|почта (брит. вар.), после|pqust
post office|почта|
postage|почтовая оплата|'pqustIdZ
postcard|открытка|'pqustkQ:d
postcards|открытки (от postcard)|
postman|почтальон (брит. вар.)|'pqustmqn
potato|картофель|pq'teItqu
potatoes|картофель (от potato)|
pound|фунт, фунт стерлингов|paund
pounds|фунты (от pound)|
pour|лить, наливать|pO:
powder|пудра|'paudq
power|сила, власть|'pauq
powerful|мощный, могущественный|'pauqful
practical|практический|'prxktIkql
practically|практически, фактически|'prxktIkqlI
practice|практика|'prxktIs
practiced|применял, практиковал (от practice)|
precinct|район, округ|'pri:sINkt
precious|драгоценный|'preSqs
precise|точный, определенный, аккуратный|prI'saIz
precisely|именно|prI'saIslI
predict|предсказывать|prI'dIkt
prefer|предпочитать|prI'fq:
preliminary|предварительный|prI'lImInqrI
prepare|готовить, готовиться|prI'pFq
preposition|предлог|,prepq'zISqn
prerecorded|предварительно записанный|
prescription|рецепт|prIs'krIpSqn
presence|присутствие|'prezns
present|подарок, представлять, настоящее время|prI'zent
presents|подарки (от present)|
preserve|сохранять|prI'zq:v
president|президент|'prezIdqnt
press|(по)гладить, сжимать, нажимать, печать, пресса|pres
pressed|поглаженный, сжатый (от press)|
pressure|давление|'preSq
prestige|престиж|pres'ti:Z
pretend|притворяться, претендовать|prI'tend
pretty|значительный, достаточно|'prItI
prevent|предотвращать|prI'vent
previous|предыдущий, преждевременный|'pri:vjqs
price|цена|praIs
prices|цены (от price)|
pride|гордость|praId
primary|первостепенный, начальный|'praImqrI
principal|директор|'prInsqpql
print|отпечаток, шрифт, печатать|prInt
private|частный, личный|'praIvIt
prize|приз, награда|praIz
probable|вероятный, возможный|'prObqbl
probably|вероятно|'prObqblI
problem|проблема|'prOblqm
problems|проблемы (от problem)|
proceed|продолжать|prq'si:d
process|процесс, ход развития|'prquses
produce|производить|'prOdju:s
producer|режиссер|prq'dju:sq
product|продукция|'prOdAkt
production|производство|prq'dAkSqn
profession|профессия|prq'feSqn
professor|профессор|prq'fesq
profit|польза, выгода|'prOfIt
program|программа|'prqugrxm
progress|прогресс|'prqugrqs
progressive|прогрессивный|prq'gresIv
prohibited|запрещенный (от prohibit)|
prolog|пролог|
promise|обещание, обещать|'prOmIs
promised|обещал (от promise)|'prOmIst
promises|обещания (от promise)|
promising|многообещающий|'prOmIsIN
pronoun|местоимение|'prqunaun
pronounce|произносить|prq'nauns
pronouns|местоимения (от pronoun)|
pronunciation|произношение|prq,nAnsI'eISqn
proof|доказательство|pru:f
proper|подходящий|'prOpq
properly|правильно|'prOpqlI
properties|свойства (от property)|
property|собственность|'prOpqtI
proposal|предложение|prq'pquzql
proposals|предложения (от proposal)|
propose|предложить|prq'pquz
pros|"за"|
prospect|перспектива|'prOspekt
prosperous|процветающий|'prOspqrqs
protect|охранять, защищать|prq'tekt
protection|защита|prq'tekSqn
protest|протест, протестовать|'prqutest
proud|гордиться|praud
proudly|гордо|'praudlI
prove|доказывать|pru:v
provide|обеспечивать|prq'vaId
province|провинция|'prOvIns
psychology|психология|saI'kOlqdZI
public|общественный|'pAblIk
public school|средняя школа|'pAblIk'sku:l
publish|опубликовывать, издавать|'pAblIS
published|публиковал, опубликованный (от publish)|
pull|тянуть, тащить|pul
pull in|прибывать (о поезде)|
pull off|добиться успеха|
pull out|тронуться, начать движение (на машине)|
pull together|взять себя в руки|
pull up|пододвигать, остановиться|
pull-over|пуловер|'pul,quvq
pulled off|добился, справился (от pull off)|
pulling somebody's leg|морочащий голову (от pull somebody's leg)|
pullman|спальный вагон|'pulmqn
pulse|пульс, биение|pAls
pump|насос, накачивать|pAmp
punish|наказывать|'pAnIS
pupil|ученик|'pju:pl
purchase|покупка, покупать|'pq:tSqs
purely|только, чисто|'pjuqlI
purple|пурпурный, фиолетовый|'pq:pl
purpose|цель|'pq:pqs
purse|сумочка (дамская)|pq:s
push|толкать, давить|puS
put|класть, размещать|put
put back|положить на место|
put off|откладывать|
put on|надеть|
put out|гасить|
put up|останавливаться (в гостинице)|
put up with|терпеть, мириться|
putting through|соединяющий, соединение (по телефону) (от put through)|
puzzle|загадка, головоломка|'pAzl
qualification|квалификация|,kwOlIfI'keISqn
quality|качество|'kwOlItI
quarrel|ссора, ссориться|'kwOrql
quarter|четверть, квартал|'kwO:tq
queen|королева|kwi:n
question|вопрос|'kwestSqn
questions|вопросы (от question)|
queue|очередь (брит. вар.)|kju:
quick|быстрый|kwIk
quickest|самый быстрый (от quick)|
quickly|быстро|'kwIklI
quiet|спокойный|'kwaIqt
quietly|спокойно, тихо|'kwaIqtlI
quit|прекращать, переставать|kwIt
quite|вполне|kwaIt
quote|цитировать, ссылаться|kwqut
rabbit|кролик|'rxbIt
race|раса, гонки|reIs
radical|радикальный|'rxdIkql
radio|радио|'reIdIqu
rag|тряпка, тряпье|rxg
rage|ярость, гнев|reIdZ
railroad|железная дорога|'reIlrqud
railway|вокзал (брит. вар.)|'reIlweI
rain|дождь|reIn
rain-coat|плащ|
rainbow|радуга|'reInbqu
raincheck|откладывание, отсрочка|
raincoat|плащ|'reInkqut
raincoats|плащи (от raincoat)|
rainy|дождливый|'reInI
raise|поднимать, увеличивать|reIz
raisin|изюм|'reIzn
raising|воспитание|
ran|бежал, убежавший (от run)|rxn
ran high|разгорелись (от run high )|
random|случайный|'rxndqm
rang|звонил (от ring)|rxN
range|сфера, область|reIndZ
rank|ряд, звание, положение, категория|rxNk
rapid|быстрый|'rxpId
rare|замечательный|rFq
rash|опрометчиво|rxS
rat|крыса|rxt
rate|тариф, расценка|reIt
rates|стоимость (от rate)|
rather|скорее, лучше|'rQ:Dq
rational|разумный, рациональный|'rxSqnl
raw|сырой|rO:
razor|бритва|'reIzq
reach|добираться до|ri:tS
reaction|реакция|rI(:)'xkSqn
read|читать|ri:d
reader|читатель|'ri:dq
reading|чтение|'ri:dIN
ready|готовый|'redI
ready-made|готовый|'redI'meId
real|весьма|reI'Q:l
real estate agency|агентство no продаже недвижимости|
realize|понимать, осуществлять|'rIqlaIz
really|неужели, действительно|'rIqlI
rear|задняя часть|rIq
reason|причина|'ri:zn
reasonable|разумный|'ri:znqbl
reasons|причины (от reason)|
receipt|квитанция|rI'si:t
receive|принимать, получать|rI'si:v
recent|недавний, современный|'ri:snt
recently|недавно|'ri:sntlI
recess|школьная перемена|rI'ses
recognize|узнавать|'rekqgnaIz
recommend|рекомендовать|,rekq'mend
record|запись, записывать, пластинка (музыкальная)|rI'kO:d
recorder|магнитофон|rI'kO:dq
recordings|записи (от recording)|
records|пластинки (от record)|
recovered|выздоровел (от recover)|rI'kAvqd
recreation|отдых, развлечение|'ri:krI'eISqn
red|красный|red
redcap|носильщик|'redkxp
reduce|уменьшить|rI'dju:s
reducing|понижение (от reduce)|
refer to|обращаться (к кому-либо), ссылаться (на что-либо)|
reference|рекомендация, справочный|'refrqns
references|рекомендации (от reference)|
refill|заправить, залить|'ri:'fIl
reflect|отражать|rI'flekt
reform|реформа, реформировать|'ri:'fO:m
refresh|освежить|rI'freS
refreshments|закуски и напитки|
refrigerator|холодильник|rI'frIdZqreItq
refusal|отказ|rI'fju:zql
refuse|отказывать, отказываться|'ri:'fju:z
regard|считаться|rI'gQ:d
regards|привет, поклон|
regime|режим|reI'Zi:m
region|регион|'ri:dZqn
register|зарегистрировать (брит. вар.)|'redZIstq
registered|заказной|'redZIstqd
regret|сожаление, сожалеть|rI'gret
regular|профессиональный|'regjulq
regularly|регулярно|
reject|отклонять, отвергать|'ri:dZekt
related|родственный|rI'leItId
relation|родственник, отношение|rI'leISqn
relations|отношения (от relation)|rI'leIS(q)nz
relationship|родственные связи|rI'leISqnSIp
relatively|относительно|'relqtIvlI
relax|расслаблять(ся)|rI'lxks
relish|удовольствие, склонность|'relIS
remain|оставаться|rI'meIn
remarkable|замечательный|rI'mQ:kqbl
remarks|ответы (от remark)|
remember|помнить, передавать привет|rI'membq
remind|напоминать|'rImaInd
remove|передвигать, переезжать|rI'mu:v
rent|сдавать в аренду|rent
rental|арендная плата|'rentl
rentals|прокат (от rental)|
repair|исправлять, ремонтировать|rI'pFq
repairs|ремонт (от repair)|
repay|отдавать долг|'ri:'peI
repeat|повторять|rI'pi:t
replace|заменять|rI'pleIs
replies|ответы (от reply)|
reply|ответ, отвечать|rI'plaI
report|доклад, отчет, докладывать, сообщать|rI'pO:t
reporter|репортер|rI'pO:tq
represent|представлять, быть представителем|,reprI'zent
representative|представитель|,reprI'zentqtIv
republic|республика|rI'pAblIk
reputation|репутация|,repju(:)'teISqn
request|просьба, просить, предлагать|rI'kwest
requested|предложенный (от request)|
requests|просьбы (от request)|
require|требовать, испытывать потребность|rI'kwaIq
required subject|обязательный предмет|
requirement|требование|rI'kwaIqmqnt
rescue|спасение, спасать|'reskju:
research|исследовательская работа|rI'sq:tS
resemble|быть похожим|rI'zembl
reservation|заказать, заказ (предварительный)|,rezq'veISqn
reservations|заранее заказанные места (от reservation)|
reserve|заказывать|rI'zq:v
resident|постоянный житель|'rezIdqnt
resign|уходить в отставку|'ri:'saIn
resources|ресурсы|
respect|уважать|rIs'pekt
responses|ответы (от response)|
rest|отдыхать|rest
restaurant|ресторан|'restqrO:N
restrict|сдерживать|rIs'trIkt
restriction|сдержанность, ограничение|rIs'trIkSqn
restrictions|ограничения (от restriction)|
result|результат|rI'zAlt
results|результаты (от result)|
retell|пересказывать|,ri:'tel
retire|уходить в отставку|rI'taIq
retold|пересказал (от retell)|
return|вернуть(ся), возвращение|rI'tq:n
returned|вернулся (от return)|
review|обозрение, обзор, делать обзор|rI'vju:
revise|пересматривать|rI'vaIz
revolt|восстание, мятеж, восставать|rI'vqult
revolution|революция|,revq'lu:Sqn
reward|награда, награждать|rI'wO:d
rhyme|рифма|raIm
ribbon|лента|'rIbqn
rice|рис|raIs
rich|богатый, обильный, яркий (о цвете)|rItS
ride|езда, прогулка (на машине, лошади, велосипеде и т.п.)|raId
right|правильный, правый, хорошо|raIt
right away|сразу|
right now|сейчас же|
right there|вон там|
ring|кольцо, звонить|rIN
rise|подниматься|raIz
risen|поднявшийся (от rise)|'rIzn
risk|риск, рисковать|rIsk
river|река|'rIvq
road|дорога|rqud
roadway|проезжая часть дороги, мостовая (брит. вар.)|'rqudweI
roared|хохотал(и) (от roar)|
roast|жареный, жаренный|rqust
rob|грабить|rOb
rock|скала, большой камень, качать(ся)|rOk
rocked the boat|нарушил(о) общее равновесие (от rock the boat)|
rocket|ракета|'rOkIt
rocky|скалистый|'rOkI
roll|булочка|rqul
roller-coaster|американские горки (аттракцион)|'rqulq,kqustq
roof|крыша|ru:f
room|комната, номер|ru:m
roomer|жилец, квартирант|'ru:mq
rooms|комнаты, номера (от room)|
rooster|петух|'ru:stq
root|корень|ru:t
rose|поднялся (от rise)|rquz
roses|розы (от rose)|
rotten|гнилой, испорченный|'rOtn
rotten luck|незадача|
rough|грубый, черновой|rAf
roughly|грубо, приблизительно|'rAflI
round|круглый|raund
round up|собрать вместе|
round-trip|туда и обратно (билет)|
route|маршрут|ru:t
row|ряд|rqu
royal|королевский|'rOIql
rubber|резина|'rAbq
rubbing alcohol|медицинский спирт|
ruby|рубиновый|'ru:bI
rude|грубый|ru:d
ruin|разрушать|ruIn
rule|правило|ru:l
ruler|правитель, линейка|'ru:lq
rum|спиртной напиток|rAm
rumor|слух, молва|
rump steak|ромштекс|'rAmp'steIk
run|бегать, двигаться|rAn
run away|убегать|
run into|столкнуться, встретиться|
run-of-the-mill|средний|
rung|позвонивший (от ring)|rAN
runner|бегун|'rAnq
running nose|насморк|
running out of|истощающийся (от run out of)|
rush|столпотворение, нестись|rAS
rush hour|час "пик"|
rush hours|часы "пик" (от rush hour)|
rye|рожь|raI
sack|мешок, увольнять|sxk
sacrifice|приносить в жертву|'sxkrIfaIs
sad|печальный|sxd
sadness|печаль, грусть|'sxdnIs
safe|безопасный, сейф|seIf
safely|безопасный|'seIflI
safety|безопасность|'seIftI
said|сказал (от say)|sed
sail|парус, прогулка на судне, плыть|seIl
sailor|моряк|'seIlq
sake|ради|seIk
salad|салат|'sxlqd
salary|жалованье, оклад|'sxlqrI
sale|распродажа|seIl
sales|спрос, распродажа (от sale)|
sales clerk|продавец, продавщица|
salmon|лосось|'sxmqn
salt|соль|sO:lt
salty|соленый|'sO:ltI
salute|приветствие, приветствовать|sq'lu:t
same|тот же, так(ой) же|seIm
sample|образец|'sQ:mpl
sand|песок|sxnd
sandal|сандалия|'sxndl
sandals|сандалии (от sandal)|
sandwich|бутерброд|'sxnwIdZ
sandwiches|бутерброды (от sandwich)|
sang|пел, спел (от sing)|sxNg
sardines|сардины (от sardine)|
sat|сидел (от sit)|sxt
satisfaction|удовлетворение|,sxtIs'fxkSqn
satisfy|удовлетворять(ся)|'sxtIsfaI
sauce|соус|sO:s
saucer|блюдце|'sO:sq
saucers|блюдца (от saucer)|
sausage|колбаса|'sOsIdZ
save|спасать, экономить, беречь|seIv
save up|копить|
saving|исключая, кроме|'seIvIN
savings|сбережения|
savings account|счет в сберегательном банке|
saw|видел, смотрел (от see)|sO:
say|сказать, говорить|seI
saying|говорящий, присловье (от say)|'seIIN
scale|весы|skeIl
scandal|позор, скандал|'skxndl
scare|испуг, пугать|skFq
scarf|шарф|skQ:f
scenario|сценарий|sI'nQ:rIqu
scene|место происшествия|si:n
schedule|программа, расписание|'Sedju:l
scholar|ученый|'skOlq
school|школа|sku:l
science|наука, научный|'saIqns
scientific|научный|,saIqn'tIfIk
scientist|ученый|'saIqntIst
scissors|ножницы|'sIzqz
score|счет|skO:
scraped|с трудом накопили (от scrape)|
scream|визг, визжать|skri:m
screamed|визжал(а), кричала (от scream)|
screen|экран|skri:n
sea|море|si:
seal|печать, пломба|si:l
seaman|моряк|'si:mqn
search|поиски, искать|sq:tS
seaside|морское побережье|'si:'saId
season|время года|'si:zn
seat|место, сиденье, сажать, усаживать|si:t
seated|уселись (от seat)|
seats|места (от seat)|
second|второй, секунда|'sekqnd
second-hand|комиссионный|
second-rate|второклассный|
secondary|средний|'sekqndqrI
secret|секрет, секретный,|'si:krIt
secretary|секретарь|'sekrqtrI
section|часть, отдел, раздел|'sekSqn
secure|безопасный|sI'kjuq
security|безопасность|sI'kjuqrItI
see|(у)видеть, встретиться|si:
see red|разозлиться|
seed|семя, зерно|si:d
seem|казаться|si:m
seems|кажется (от seem)|
seen|увиденный (от see)|si:n
seldom|редко|'seldqm
select|выбирать|sI'lekt
self-made|обязанный всем самому себе|
self-service|самообслуживание|
sell|продавать, надувательство (разг.)|sel
sell out|распродать|
sells|продается (от sell)|
semester|семестр|sI'mestq
seminar|семинар|'semInQ:
send|отправлять, посылать|send
send back|возвращать|
send off|отсылать по почте|
senior|старший, четверокурсник|'si:njq
sense|смысл, значение|sens
sensitive|чувствительный|'sensItIv
sent|отправил, послал, отправленный, посланный (от send)|sent
sentence|предложение|'sentqns
sentiment|чувство|'sentImqnt
sentimental|чувствительный, сентиментальный|,sentI'mentl
separate|отдельный, отделять|'sepqreIt
serial|сериал|'sIqrIql
series|серия|'sIqri:z
serious|серьезный|'sIqrIqs
seriously|серьезно|
servant|слуга, прислуга|'sq:vqnt
serve|служить, подавать (в ресторане)|sq:v
serves|отплатит (от serve) (разг.)|
service|обслуживание, сервис|'sq:vIs
service station|станция техобслуживания|'sq:vIs'steISqn
services|служба быта, ремонт (от service)|
set|класть, ставить|set
set|комплект, телевизор|set
set in|наступать|
set out|отправляться|
set up|воздвигать, сооружать|
settle|решать, принимать решение, поселяться|'setl
seven|семь|'sevn
seventeen|семнадцать|'sevn'ti:n
seventh|седьмой|'sevnT
seventy|семьдесят|'sevntI
several|несколько|'sevrql
sew|шить|sju:
sex|пол|seks
shade|тень, оттенок, штора|SeId
shades|оттенки (от shade)|
shadow|тень|'Sxdqu
shake|трясти, встряхивать|SeIk
shall|вспомогательный глагол, модальный глагол|Sxl
shame|стыд, досада|SeIm
shampoo|мытье головы, шампунь|Sxm'pu:
shape|вид, форма|SeIp
share|разделять|SFq
shark|акула|SQ:k
sharp|точно, ровно|SQ:p
shave|(по)бриться, бритье|SeIv
shaving|бритье|'SeIvIN
she|она|Si:-
sheep|овца|Si:p
sheet|простыня, лист (бумаги и т.п.)|Si:t
shelf|полка|Self
shelter|приют, убежище, приютить|'Seltq
sherbet|щербет (напиток)|'Sq:bqt
shine|светить, сиять|SaIn
shingle|вывеска|'SINgl
ship|пароход|SIp
shirt|рубашка|Sq:t
shirts|рубашки (от shirt)|
shivery|дрожащий|'SIvqrI
shoe|ботинок, туфля|Su:
shoes|обувь, туфли (от shoe)|
shoot|стрелять, промчаться|Su:t
shop|магазин, мастерская|SOp
shop around|разузнать (навести справки)|
shopper|покупатель|'SOpq
shopping|покупки|'SOpIN
shopping bag|хозяйственная сумка|
shops|магазины (от shop)|
shore|берег|SO:
short|короткий|SO:t
shortage|нехватка, недостаток|'SO:tIdZ
shortcoming|недостаток, дефект|SO:t'kAmIN
shorten|укорачивать|'SO:tn
shorter|короче (от short)|
shortly|скоро|'SO:tlI
shorts|шорты|SO:ts
shot|попытка|SOt
should|следует|Sud
shoulder|плечо|'Squldq
shouldn't|не следует (от should not)|
shout|крик, кричать|Saut
shovel|лопата|'SAvl
show|показывать, демонстрировать, показ, зрелище|Squ
show up|приходить, показывать, изобличать|
showed|показал (от show)|
shower|ливень, душ|'Squq
shown|показанный (от show)|Squn
shred|резать, кромсать|Sred
shut|закрывать|SAt
shut down|закрывать, прекращать работу|
shut off|выключать|
shut up|замолкать|
sick|больной, уставший (разг.)|sIk
sickness|болезнь, тошнота|'sIknIs
side|сторона, кран, склон|saId
sidewalk|тротуар|'saIdwO:k
sight|вид|saIt
sights|достопримечательности (от sight)|
sightseeing|осматривать достопримечательности|'saIt,si:IN
sightseer|турист|'saIt,si:q
sign|признак, знак, подписывать|saIn
signal|знак, сигнал, сигнализировать|'sIgnl
signature|подпись|'sIgnItSq
signs|знаки, вывески (от sign)|
silence|тишина|'saIlqns
silent|тихий|'saIlqnt
silently|тихо|
silk|шелковый, шелк|sIlk
silly|глупый|'sIlI
silver|серебро, серебряный|'sIlvq
similar|похожий (на), сходный (с)|'sImIlq
simple|простой, обычный|'sImpl
simply|просто, легко|'sImplI
since|с, с тех пор, как, поскольку|sIns
sincere|искренний|sIn'sIq
sincerely|искренне|
sing|петь|sIN
singer|певец, певица|'sINq
single|один, одинокий|'sINLgl
singular|единственное число|'sINgjulq
sink|раковина|sINk
sink|тонуть, погружаться|sINk
sister|сестра|'sIstq
sit|сидеть|sIt
sit down|садиться|
sit up|(внезапно) заинтересоваться|
situation|ситуация|,sItju'eISqn
situations|места (от situation)|
six|шесть|sIks
sixpence|сумма в 6 пенсов|'sIkspqns
sixteen|шестнадцать|'sIks'ti:n
sixth|шестой|sIksT
sixty|шестьдесят|'sIkstI
size|размер|saIz
skate|конек, кататься на коньках|skeIt
sketch|набросок, эскиз|sketS
ski|ходить на лыжах|ski:
skill|мастерство, искусство|skIl
skilled|квалифицированный, умелый|skIld
skillful|искусный, умелый|
skin|кожа, шкура|skIn
skin diving|подводное плавание|
skirt|юбка|skq:t
sky|небо|skaI
skyrocket|быстро расти (о продукции)|
slack|слабый|slxk
slam|хлопать|slxm
sled|сани|sled
sleep|спать|sli:p
sleeper|спальный вагон (брит. вар.)|'sli:pq
sleeping-car|спальный вагон|'sli:pINkQ:
sleepy|сонный|'sli:pI
sleeve|рукав|sli:v
slender|тонкий, стройный|'slendq
slept|спал (от sleep)|slept
slice|ломтик|slaIs
slick|превосходный|slIk
slide|слайд, скользить|slaId
slight|слабый, незначительный|slaIt
slip|клочок, поскользнуться, проскользнуть|slIp
slippers|комнатные туфли (от slipper)|
slippery|скользкий|'slIpqrI
slope|склон, косогор, наклонять|slqup
slow|медленный|slqu
slow down|замедлять ход, снижать скорость|
slower|помедленнее (от slow)|
slowly|медленно|'sloulI
small|маленький|smO:l
small-talk|пустая болтовня|
smaller|меньше (от small)|
smart|умный, толковый|smQ:t
smash|успешный (разг.)|smxS
smell|запах, нюхать, пахнуть|smel
smile|улыбка, улыбаться|smaIl
smoke|курить|smquk
smokers|курящие (от smoker)|
smoking|курение|
snack|закуска|snxk
snack bar|закусочная, буфет|'snxkbQ:
snake|змея|sneIk
snazzy|модный|'snxzI
sneakers|кроссовки|'sni:kqz
snow|снег|snqu
snowfall|снегопад|
snowing|падающий снег (от snow)|snquIN
snowstorm|вьюга|
snowy|снежный|'snquI
so|так, таким образом, итак|squ
so far|пока|
so-and-so|такой-то (вместо имени)|'squqnsqu
soap|мыло|squp
sober|трезвый, здравомыслящий|'squbq
soccer|футбол|'sOkq
social|общественный, социальный|'squSql
society|общество|sq'saIqtI
sock|носок|sOk
socks|носки (от sock)|
soda-water|содовая вода|
sofa|диван|'squfq
soft|мягкий, негромкий, неяркий|sOft
softly|осторожно|
soil|земля, почва|sOIl
sold|продавал, проданный (от sell)|squld
soldier|солдат|'squldZq
sole|камбала|squl
solid|твердый, сплошной, целый|'sOlId
solidarity|солидарность|,sOlI'dxrItI
solution|решение|sq'lu:Sqn
solve|решать, разрешать|sOlv
some|немного, несколько|sAm
somebody|кто-нибудь|'sAmbqdI
somehow|как-нибудь|'sAmhau
someplace|где-то, где-нибудь, куда-то|'sAmpleIs
something|что-то, что-нибудь|'sAmTIN
sometimes|иногда|'sAmtaImz
somewhere|где-нибудь|'sAmwFq
son|сын|sAn
son's|сыновьи|
song|песня|sON
soon|скоро, вскоре|su:n
sophomore|второкурсник|'sOfqmO:
sore|больной, обиженный|sO:
sorrow|печаль, горе, печалиться|'sOrqu
sorry|сожалеющий|'sOrI
sort|сорт, род, вид|sO:t
soul|душа|squl
sound|звук|saund
sounding|звучащий (от sound)|'saundIN
sounding board|дека|
sounds|звуки (от sound)|
sounds|звучит (от sound)|
soup|суп|su:p
sour|кислый|'sauq
south|юг|sauT
southern|южный|'sADqn
space|пространство, место, космос|speIs
spare|уделять, лишний, запасный|spFq
spat|небольшая ссора, слегка поссориться|spxt
speak|говорить|spi:k
speaker|оратор, докладчик|'spi:kq
speaking|говоря(щий), разговор (от speak)|'spi:kIN
special|специальный, фирменный|'speSql
specialist|специалист|'speSqlIst
specific|особый, специфический, характерный|spI'sIfIk
speech|выступление, речь|spi:tS
speed|скорость|spi:d
speed up|набирать скорость, ускорять|
speedway|дорога со скоростным движением|'spi:dweI
spell|называть по буквам; короткий промежуток времени|spel
speller|букварь|'spelq
spelling|правописание|'spelIN
spend|проводить (время), тратить (деньги)|spend
spent|проводил, тратил, проведенный, потраченный (от spend)|spent
spice|специя|spaIs
spigot|кран, вентиль|'spIgqt
spill|проливать, разливать|spIl
spirit|дух, душа|'spIrIt
split|раскалывать|splIt
spoil|портить, баловать|spO:Il
spoke|говорил, говоривший (от speak)|spquk
spoken|разговорный (от speak)|'spqukqn
spoon|ложка|spu:n
spoons|ложки (от spoon)|
sport|спорт|spO:t
sporting|спортивный|'spO:tIN
sports|спортивный|spO:ts
sportsman|спортсмен|'spO:tsmqn
spot|место, пятно|spOt
spouse|супруг, супруга|spauz
sprang a surprise|сделал сюрприз (от spring a surprise)|
spread|распространять, расстилать(ся)|spred
spring|весна|sprIN
sprung upon|застал(а) врасплох (от spring upon)|
square|площадь, квадратный|skwFq
squash|кабачок (овощ)|skwOS
squirrel|белка|'skwIrql
stability|устойчивость, стабильность|stq'bIlItI
stable|устойчивый, стабильный|'steIbl
staff|служебный|stQ:f
stage|сцена|steIdZ
stairway|лестница|'stFqweI
stamp|марка, печать, штамп, наклеивать марку|stxmp
stamped|маркированный (от stamp)|
stamps|марки (от stamp)|
stand|остановка, позиция, стоять|stxnd
stand for|означать|
stand out|выделяться|
stand up|вставать|
standard|стандарт, образец, норма|'stxndqd
stands|имеет (шанс) (от stand)|
star|звезда|stQ:
stare|пристально смотреть|stFq
stars|судьба, рок (от star)|
start|начинать, отправляться|stQ:t
start out|отправляться|
started|начал (от start)|
starter|стартер|'stQ:tq
startled|поражен (от startle)|
state|состояние, государство, заявлять|steIt
statement|заявление, утверждение|'steItmqnt
station|станция|'steISqn
stationery|канцелярские принадлежности|'steISnqrI
status|статус, общественное положение|'staeItqs
staunch|верный, прочный|stO:ntS
stay|оставаться, жить (временно)|steI
stay out|отсутствовать, нe быть дома|
stay up|засидеться, не ложиться спать|
staying|остающийся, живущий (от stay)|'steIIN
steady|устойчивый, постоянный|'stedI
steal|воровать, красть|sti:l
steam|пар|sti:m
steel|сталь|sti:l
steer|управлять, вести|stIq
step|шаг, шагнуть|step
step up|увеличивать|
stereo|стерео|'stIqrIqu
steward|проводник (брит. вар.)|stjuqd
stewed fruit|компот|
stick|палка|stIk
stick|прикалывать, приклеивать, класть|stIk
stick it out|не поддавайся|
still|пока еще|stIl
stipend|стипендия|'staIpend
stocking|чулок|'stOkIN
stockings|чулки (от stocking)|
stolen|украденный (от steal)|'stqulqn
stomach|живот, желудок|'stAmqk
stomach-ache|боль в животе|'stAmqkeIk
stomatologist|стоматолог|
stone|камень|stqun
stood|стоял(и) (от stand)|stud
stop|остановка, перестать, остановиться|stOp
stop up|закрывать|
store|магазин|stO:
storey|этаж|'stO:rI
stories|рассказы (от story)|
storm|шторм, буря|stO:m
story|рассказ, история|'stO:rI
stove|плита|stquv
straight|прямо, сразу|streIt
straight from the shoulder|прямо, откровенно|
strange|странный, незнакомый, чужой|streIndZ
stranger|чужестранец|'streIndZq
straw|капля|strO:
strawberries|клубника (от strawberry)|
strawberry|земляника, клубника|'strO:bqrI
street|улица|stri:t
streetcar|трамвай|'stri:t'kQ:
strength|сила|streNT
stress|ударение, подчеркивать, делать ударение|stres
stretch|тянуть(ся), вытягивать(ся)|stretS
strike|забастовка, поражать, удивлять|straIk
striking|замечательный|'straIkIN
string|вереница, ряд|strIN
string beans|фасоль|
stroke|удар|strquk
stroke of luck|удача|
stroll|прогулка, прогуливаться|strqul
strong|крепкий|strON
struck|ударила (от strike)|strAk
struggle|борьба, бороться|'strAgl
strеаm|поток, ручей|
stubborn|упорный, упрямый|'stAbqn
student|студент(ка)|'stju:dqnt
study|рабочий кабинет|'stAdI
studying|изучающий (от study)|
stuff|материя, вещество, вещи, засовывать|stAf
style|стиль, фасон, прическа|staIl
subject|подверженный|'sAbdZIkt
subscribe|подписываться (на газеты и т.п.)|sqb'skraIb
subscription|подписка|sqb'skrIpSqn
substitute|заменять, замещать|'sAbstItju:t
subtle|тонкий, проницательный|'sAtl
subtract|вычитать|sqb'trxkt
suburb|пригород|'sAbq:b
suburbs|окраина, окрестности (от suburb)|
subway|метро|'sAbweI
succeed|достигать цели, добиваться успеха|sqk'si:d
succeses|успехи (от success)|
success|успех|sqk'ses
successful|успешный|sqk'sesful
successfully|успешно|s(q)k'sesfulI
such|такой|sAtS
sudden|внезапный|'sAdn
suddenly|неожиданно|'sAdnlI
suede|замшевый|sweId
suffer|страдать, терпеть|'sAfq
sugar|сахар|'Sugq
sugar-bowl|сахарница|'Sugqbqul
suggest|предлагать|sq'dZest
suggestion|предложение|sq'dZestSqn
suggestions|предложения (от suggestion)|
suit|костюм, подходить, устраивать|sju:t
suitable|подходящий|'sju:tqbl
suitcase|чемодан|'sju:tkeIs
suitcases|чемоданы (от suitcase)|
suite|люкс|swi:t
suits|устраивает (от suit)|
sum|сумма|sAm
summarize|суммировать|'sAmqraIz
summer|лето, летний|'sAmq
sun|солнце|sAn
sunbathe|загорать|
sunbathing|солнечная ванна (от sunbath)|
sunburn|загар|'sAnbq:n
sung|спевший (от sing)|sAN
sunny|солнечный|'sAnI
sunrise|восход|'sAnraIz
sunset|закат|'sAnset
sunstroke|солнечный удар|'sAnstrquk
superb|великолепный|sju(:)'pq:b
supermarket|супермаркет|'sju:pq,mQ:kIt
supper|ужин|'sApq
supplies|содержание (от supply)|
supply|снабжение, запасы, снабжать|sq'plaI
support|поддержка, поддерживать|sq'pO:t
suppose|полагать, предполагать|sq'pquz
suppress|подавлять, пресекать|sq'pres
sure|уверенный, конечно|Suq
surface|поверхность|'sq:fIs
surname|фамилия (брит. вар.)|'sq:neIm
surprise|удивление|sq'praIz
suspect|подозревать|sqs'pekt
suspenders|подтяжки|
swallow|глотать|'swOlqu
swam|плавал (от swim)|swxm
sweater|свитер|'swetq
sweet|сладкий|swi:t
sweets|конфеты (брит. вар.)|
swell|отличный, превосходный|swel
swelling|воспаление|'swelIN
swim|плавать|swIm
swimmer|пловец|'swImq
swimming|плавание, плавающий|'swImIN
switch|электрический выключатель|swItS
switch off|выключить|
switch on|включить|
swum|уплывший (от swim)|swAm
sympathise|сочувствовать|
sympathy|сочувствие|'sImpqTI
symphonic|симфонический|sIm'fOnIk
symptom|симптом|'sImptqm
synthetic|синтетический|sIn'TetIk
syrup|сироп|'sIrqp
system|система|'sIstIm
table|стол|'teIbl
tablets|таблетки (от tablet)|
tacks|линии (от tack)|
tag|этикетка|txg
tail|хвост|teIl
take|брать, взять, принимать|teIk
take a crack at|пытаться сделать (что-либо)|
take away|забирать, отнимать, вычитать|
take back|возвращать|
take care of|присматривать, заботиться|
take down|записывать|
take in|понимать, обманывать|
take issue with|спорить|
take it for granted|считать само собой разумеющимся|
take off|отправляться|
take on|брать на работу|
take out|вынимать, приглашать (в ресторан, театр и т.п.)|
take over|брать под контроль, замещать (кого-либо)|
take up|занимать, начать заниматься (чем-либо)|
taken|занятый (от take)|'teIkqn
taken in|обманутый (от take in)|
tale|рассказ, повесть|teIl
talent|талант|'txlqnt
talk|говорить, беседовать|tO:k
talk of the devil|легок на помине|
talk over|обсуждать|
talked|болтал, говорил (от talk)|
tall|невероятный|tO:l
tan|загар|txn
tangerines|мандарины (от tangerine)|
tap|слегка стукнуть|txp
tape|лента|teIp
tape-recorder|магнитофон|'teIprI,kO:dq
target|цель, мишень|'tQ:gIt
tariff|тариф|'txrIf
task|задание, урок, задача|tQ:sk
taste|вкус, пробовать, иметь вкус|teIst
tasty|вкусный|'teIstI
tax|спрашивать, назначать цену (разг.)|txks
taxes|налоги|
taxi|такси (брит. вар.)|'txksI
tea|чай|ti:
teach|обучать, преподавать|ti:tS
teacher|учитель|'ti:tSq
team|команда|ti:m
tear|слеза|tFq
tear down|сносить|
tear out|вырвать|
tear up|разорвать|
technical|технический|'teknIkql
technology|технической|tek'nOlqdZI
teenager|подросток|'ti:neIdZq
teenagers|подростки (от teenager)|
telegram|телеграмма|'telIgrxm
telephone|телефон|'telIfqun
television|телевидение|'telI,vIZqn
tell|говорить, рассказывать|tel
tell that to the marines|ври больше|
teller|кассир|'telq
temper|сдержанность, самообладание|'tempq
temperature|температура|'temprItSq
ten|десять|ten
tenant|арендатор, жилец|'tenqnt
tender|нежный, мягкий|'tendq
tennis|теннис|'tenIs
tense|натянутый, напряженный|tens
tension|напряжение|'tenSqn
tent|палатка|tent
tenth|десятый|tenT
term|срок, семестр|tq:m
terminal|конечный пункт|'tq:mInl
terms|личные отношения|
terrible|ужасный|'terqbl
terrific|чудесный|tq'rIfIk
territory|территория|'terItqrI
terror|ужас, террор|'terq
test|анализ, проверка|test
testify|свидетельствовать|'testIfaI
tests|анализы (от test)|
text|текст|tekst
textbook|учебник, руководство|'tekstbuk
textiles|ткани (от textile)|
than|чем|Dxn
thank|благодарить|TxNk
thanks|спасибо|
that|это, тот, та, то|Dxt
that's|это есть (от that is)|
thawing|тающий (от thaw)|
the|определенный артикль|Di:
theater|театр|'TIqtq
their|их (на вопрос "чей?")|DFq
them|их (на вопрос "кого?" "что?")|Dqm
themselves|сами|Dqm'selvz
then|тогда, затем, после этого, в таком случае|Den
theory|теория|'TIqrI
there|там, туда, вот|DFq
therefore|поэтому, следовательно|'DFqfO:
thermometer|термометр|Tq'mOmItq
thermos bottle|термос|
these|эти, это|Di:z
they|они|DeI
thick|толстый, густой|TIk
thickness|толщина|'TIknIs
thief|вор|Ti:f
thin|тонкий, редкий, жидкий|TIn
thing|вещь, предмет, дело|TIN
things|вещи, дела (от thing)|
think|думать|TINk
think over|обдумывать|
think up|изобретать|
thinks|думает (от think)|
third|третий|Tq:d
thirst|жажда|Tq:st
thirsty|томимый жаждой|'Tq:stI
thirteen|тринадцать|'Tq:'ti:n
thirteenth|тринадцатый|'Tq:'ti:nT
thirty|тридцать|'Tq:tI
this|этот, это|DIs
those|тот, та, то, те|Dquz
though|все-таки, однако же|Dqu
thought|думал, обдуманный (от think)|TO:t
thousand|тысяча|'Tauzqnd
thrash out|тщательно обсуждать|
thread|нитки|Tred
threat|угроза|Tret
three|три|Tri:
throat|горло|Trqut
through|через, сквозь, от начала до конца|Tru:
throughout|повсюду, везде|Tru(:)'aut
throw|бросать, кидать|Trqu
thunder|гром|'TAndq
thunderstorm|гроза|'TAndqstO:m
ticket|билет|'tIkIt
ticket office|касса|
tickets|билеты (от ticket)|
tidy|значительный (разг.)|'taIdI
tie|галстук, завязывать|taI
tie up|привязывать, связывать|
ties|галстуки (от tie)|
tiger|тигр|'taIgq
tight|крепко|taIt
tighten|сжимать|'taItn
till|до, до тех пор пока|tIl
time|время, срок, раз|taIm
times|раз, времена (от time)|
tint|тон, оттенок|tInt
tiny|крошечный, очень маленький|'taInI
tip|чаевые, давать чаевые|tIp
tire|шина|'taIq
tired|усталый, утомленный|'taIqd
title|заглавие, название|'taItl
to|предлог, вводящий адресата, частица инфинитива|tu:
toast|тост|tqust
toasts|тосты (от toast)|
tobacco|табак|tq'bxkqu
today|сегодня|tq'deI
today's|сегодняшний (от today)|
toe|палец ноги|tqu
together|вместе|tq'geDq
toilet|туалет|'tOIlIt
told|рассказывал (от tell)|tquld
tomato|томат, помидор|tq'mQ:tqu
tomorrow|завтра|tq'mOrqu
ton|тонна|tO:N
tongue|язык|tAN
tonight|сегодня вечером|tq'naIt
too|слишком, тоже|tu:
too bad|очень жаль|
tool|инструмент|tu:l
tooth|зуб|tu:T
tooth-paste|зубная паста|'tu:TpeIst
toothache|зубная боль|'tu:TeIk
toothbrush|зубная щетка|
top|верх, крышка, верхний|tOp
top notch|первоклассный|
top secret|большой секрет|
topic|предмет, тема|'tOpIk
toss|бросание|tOs
total|весь, полный|'tqutl
total|суммировать|'tqutl
totally|полностью|
touch|соприкосновение, контакт|tAtS
tough|жесткий, прочный|tAf
tour|поездка, турне|tuq
tourism|туризм|
tours|экскурсии (от tour)|
toward|к, по направлению, для|tq'wO:d
towel|полотенце|'tauql
tower|башня, вышка|'tauq
town|город|taun
toy|игрушка|tOI
toys|игрушки (от toy)|
trace|небольшое количество, след, прослеживать|treIs
track|платформа|trxk
trade|специальность|treId
tradition|традиция|trq'dISqn
traffic|транспорт|'trxfIk
tragedy|трагедия|'trxdZIdI
tragic|трагический|'trxdZIk
train|поезд|treIn
trains|поезда (от train)|
tram|трамвай (брит. вар.)|trxm
transfer|переносить, переводить, передавать|'trxnsfq(:)
transform|преобразовывать, превращать|trxns'fO:m
transformation|преобразование, превращение|,trxnsfq'meISqn
transit|транзит|'trxnsIt
translate|переводить|trxns'leIt
translation|перевод|trxns'leISqn
transport|транспорт, перевозить|trxns'pO:t
travel|путешествовать|'trxvl
traveled|путешествовал (от travel)|
traveler|путешественник|
traveling|путешествие|
tread|наступать|tred
treasure|клад, сокровище|'treZq
treat|удовольствие|tri:t
treating|относящийся (от treat)|
treatment|лечение, уход|'tri:tmqnt
treaty|договор|'tri:tI
tree|дерево|tri:
trend|тенденция|trend
trespassing|посягающий (от trespass)|
trial|попытка|'traIql
tribe|племя|traIb
tribune|трибуна|'trIbju:n
trick|хитрость, обман, обманывать|trIk
tricky|трудный|'trIkI
tried|постарался (от try)|traId
trim|стрижка, подрезка|trIm
trip|поездка, путешествие (короткое)|trIp
trips|поездки (от trip)|
triumph|триумф|'traIqmf
troops|войска, эскадрон|tru:ps
trouble|неприятность, беда, беспокоиться|'trAbl
troubles|неприятности (от trouble)|
trousers|брюки|'trauzqz
truck|грузовик|trAk
true|правда|tru:
truly|правдиво, точно|'tru:lI
truth|правда, истина|tru:T
try|пробовать, пытаться|traI
try on|примерять|
try out|опробовать|
trying|пытающийся (от try)|'traIIN
tube|метро (брит. вар.)|tju:b
tune|мелодия, мотив|tju:n
tunnel|туннель|'tAnl
turkey|индейка|'tq:kI
turn|поворачивать, вращать, оборот, поворот, очередь|tq:n
turn away|прогонять|
turn back|возвращаться|
turn down|отказываться, убавлять (свет, звук)|
turn in|сдавать, возвращать, ложиться спать|
turn off|закрыть (кран), выключить (свет)|
turn out|производить, выпускать|
turn over|переворачиваться|
turn up|появляться, приходить, усилить (звук)|
turns|очередь (от turn)|
tuxedo|смокинг|tAk'si:dqu
twelve|двенадцать|twelv
twenty|двадцать|'twentI
twice|дважды, вдвое|twaIs
twin|двухкассетный|twIn
twist|скручивать, вертеть, поворачивать|twIst
two|два|tu:
type|тип, вид, писать на машинке|taIp
ugly|некрасивый|'AglI
umbrella|зонт|Am'brelq
umbrellas|зонты (от umbrella)|
unable|неспособный, не умеющий|'An'eIbl
unbelief|неверие|'AnbI'li:f
uncle|дядя|'ANkl
under|под, ниже|'Andq
underline|подчеркивать|,Andq'laIn
understand|понимать|,Andq'stxnd
understanding|понимание|,Andq'stxndIN
understood|понимал, понятый (от understand)|,Andq'stud
underwear|нижнее белье|'AndqwFq
undoubtedly|несомненно|
undress|раздевать(ся)|'An'dres
unequal|неравный|'An'i:kwql
uneven|неровный, нечетный|'An'i:vqn
unfold|развертывать, расстилать(ся), открывать|'An'fquld
unfortunate|неудачный|An'fO:tSnIt
unhappy|несчастный, неудачный|An'hxpI
uniform|форменная одежда, униформа|'ju:nIfO:m
unilateral|односторонний|'ju:nI'lxtqrql
union|союз, объединение|'ju:njqn
unique|уникальный|ju:'ni:k
unite|соединять, объединять|ju:'naIt
units|единицы (от unit)|
universe|мир, вселенная|'ju:nIvq:s
university|университет|,ju:nI'vq:sItI
unknown|неизвестный|'An'nqun
unless|если не|qn'les
unlike|непохожий|'An'laIk
unlikely|маловероятный|An'laIklI
unlock|отпирать, открывать|'An'lOk
unlucky|неудача|An'lAkI
unmarried|неженатый, незамужняя|'An'mxrId
unrest|беспорядок, волнения|'An'rest
unskilled|неквалифицированный|'An'skIld
until|до, до тех пор|qn'tIl
unusual|необыкновенный|An'ju:Zuql
unwell|нездоровый|'An'wel
up|вверх, до предела, вплоть до|Ap
up in the air|нерешенный, неопределенный|
up to|вплоть до|
up to par|на должном уровне|
up to the mark|хуже обычного|
upheaval|переворот|Ap'hi:vql
upper|верхний|'Apq
ups and downs|удачи и неудачи|
upset|расстраивать, расстройство|Ap'set
upset|расстраиваться, опрокидывать|Ap'set
upstairs|наверху, вверх по лестнице|'Ap'stFqz
upward|вверх, выше|'Apwqd
urgent|срочный|'q:dZqnt
us|нас, нам|As
use|(ис)пользование, (вос)пользоваться|ju:z
used|использованный, подержанный (от use)|ju:zd
useful|полезный|'ju:sful
useless|бесполезный|'ju:slIs
usual|обычный|'ju:Zuql
usually|обычно|'ju:ZuqlI
utilize|использовать|'ju:tIlaIz
utter|произносить|'Atq
vacancies|вакансии (от vacancy)|
vacancy|пробел|'veIkqnsI
vacant|свободный|'veIkqnt
vacation|отпуск, каникулы|vq'keISqn
vacations|каникулы (от vacation)|
vaccination|прививка|,vxksI'neISqn
vacuum cleaner|пылесос|'vxkjuqm,kli:nq
vain|напрасный, тщетный|veIn
valuable|ценный|'vxljuqbl
value|стоимость|'vxlju:
variety|разнообразие, множество|vq'raIqtI
various|различный|'vFqrIqs
vase|ваза|vQ:z
veal|телятина|vi:l
vegetable|овощ|'vedZItqbl
vegetables|овощи (от vegetable)|'vedZtqblz
vehicle|средство передвижения|'vi:Ikl
velocity|скорость|vI'lOsItI
ventilator|вентилятор|'ventIleItq
venture|предприятие, риск|'ventSq
verb|глагол|vq:b
verbs|глаголы (от verb)|
version|версия|'vq:Sqn
very|очень|'verI
vest|жилет|vest
vexed|сердил, раздражал (от vex)|vekst
via|через|'vaIq
victory|победа|'vIktqrI
video|видео|'vIdIqu
video-player|видеоплейер|
view|вид|vju:
viewer|обозреватель|'vju:q
views|виды (от view)|
village|деревня, село|'vIlIdZ
vinegar|уксус|'vInIgq
violence|насилие|'vaIqlqns
violent|сильный|'vaIqlqnt
violet|фиолетовый|'vaIqlIt
virtual|фактический|'vq:tjuql
visa|виза|'vi:zq
visit|визит, посещать, навещать|'vIzIt
visitor|посетитель, гость|'vIzItq
visitors|гости (от visitor)|
vital|жизненный, насущный|'vaItl
vocabulary|запас слов, словарь|vqu'kxbjulqrI
voice|голос|vOIs
void|недействительный|vOId
volleyball|волейбол|
volume|объем, громкость|'vOljum
voluntary|добровольный|'vOlqntqrI
voter|избиратель|'vqutq
waffle|вафля|'wOfl
wage|заработная плата|weIdZ
wagon|детская коляска (разг.)|'wxgqn
waist|талия|weIst
wait|ждать, обслуживать (за столом)|weIt
waiter|официант|'weItq
waiting|ожидание, ожидающий (от wait)|'weItIN
wake|будить, просыпаться|weIk
walk|гулять, ходить пешком|wO:k
walking|ходьба, гуляющий|'wO:kIN
wall|стена, стенной|wO:l
wallet|бумажник|'wOlIt
want|хотеть, желать, нуждаться в|wOnt
wanted|хотел, желанный (от want)|
war|война|wO:
war-path|воинственное настроение|
wardrobe|платяной шкаф|'wO:drqub
warm|теплый|wO:m
warmer|теплее (от warm)|'wO:mq
warn|предупреждать, предостерегать|wO:n
warning|пpeдупpeждение, предостережение|'wO:nIN
was|был (от be)|wOz
wash|мытье, стирка, мыть, стирать|wOS
washbowl|умывальник|'wOSbqul
washed out|утомленный (о человеке)|
washer|стиральная машина|'wOSq
washingtonians|вашингтонцы (от washingtonian)|
waste|тратить|weIst
watch|часы, cмотреть, наблюдать|wOtS
watch out|быть настороже|
watches|часы (от watch)|
watching|просмотр|
water|вода|'wO:tq
waterfall|водопад|'wO:tqfO:l
watermelon|арбуз|
waterproof|непромокаемый|'wO:tqpru:f
wave|волна, качаться|weIv
way|дорога, путь, способ|weI
way in|вход|
way out|выход|
we|мы|wi:
we'll|мы будем (от we will, we shall)|wi:l
we're|мы есть (от we are)|wIq
we've|мы имеем (от we have)|wi:v
weak|слабый|wi:k
wealth|богатство|welT
wealthy|богатый|'welTI
weapon|оружие|'wepqn
wear|носить|wFq
wearing|либо одежду (от wear)|'wFqrIN
weather|погода|'weDq
wedding|обручальное|'wedIN
week|неделя|wi:k
weekend|выходные|'wi:k'end
weekly|eжeнeдeльный, еженедельно|'wi:klI
weigh|иметь значение, весить|weI
weight|вес, тяжесть, груз|weIt
welcome|приветствовать, добро пожаловать|'welkqm
well|хорошо, здоровый|wel
well in advance|заранее|
well-off|состоятельный|'wel'Of
well-paid|хорошо оплачиваемый|
went|шел, ехал (от go)|went
went out of his way|всячески старался (от go out of one's way)|
were|были (от be)|wq:
west|запад|west
western|западный|'westqn
wet|мокрый|wet
what|что, какой|wOt
whatever|что бы ни, все что|wOt'evq
wheel|колесо|wi:l
when|когда|wen
whenever|всякий раз когда|wen'evq
where|где, куда|wFq
where (from)|откуда|
wherever|где бы ни, куда бы ни|wFqr'evq
whether|ли|'weDq
which|который|wItS
while|пока, в то время, как|waIl
whip|хлестать, подгонять|wIp
whisky|виски|'wIskI
whisper|шепот, шептать|'wIspq
whistle|свист, свисток, свистеть|'wIsl
white|белый|waIt
who|кто|hu:
who cares|все равно|
whoever|кто бы ни|hu(:)'evq
whole|целое|hqul
whom|кому, кого|hu:m
whose|чей|hu:z
why|почему|waI
wide|широкий, широко, далеко|waId
width|ширина, широта|wIdT
wife|жена|waIf
wife's|жены (от wife)|
wild|неистовый, исступленный|waIld
will|вспомогательный глагол будущего времени|wIl
win|выигрывать, побеждать|wIn
wind|ветер|waInd
windfall|неожиданная удача|'wIndfO:l
window|окошко|'wIndqu
window-shopping|рассматривание витрин|'wIndqu,SOpIN
windows|окна (от window)|
windscreen|ветровое стекло (брит. вар.)|
windshield|ветровое стекло|'wIndSi:ld
windy|ветреный|'wIndI
wine|вино|waIn
wine-glass|рюмка|
wing|крыло|wIN
winner|победитель|'wInq
winter|зима|'wIntq
wipe|вытирать|waIp
wire|проволока, провод|'waIq
wires|линии (от wire)|
wisdom|мудрость|'wIzdqm
wise|мудрый|waIz
wisely|мудро|
wish|желание, желать|wIS
wished|желал (от wish)|
wishes|пожелания (от wish)|
with|с|wID
withdraw|брать назад|wID'drO:
within|в, в пределах|wI'DIn
without|без|wI'Daut
woke|будил (от wake)|wquk
woken|разбуженный (от wake)|'wqukqn
woman|женщина|'wumqn
women|женщины (от woman)|'wImIn
women's|женская (от women)|
won|победил, побежденный (от win)|wAn
won't|не будет (от will not)|wqunt
wonder|интересоваться, удивляться|'wAndq
wonderful|замечательный, чудесный|'wAndqful
wood|лес, дерево (материал)|wud
wooden|деревянный|'wudn
wool|шерсть|wul
woolen|шерстяной|'wulqn
word|слово|wq:d
words|слова (от word)|
work|работать, работа|wq:k
work out|подсчитывать, иметь успех|
worked|работал, сработанный (от work)|
worker|рабочий|'wq:kq
workers|рабочие (от worker)|
working|рабочий, работа|'wq:kIN
workshop|мастерская|'wq:kSOp
world|мир|wq:ld
worry|беспокоиться|'wArI
worse|хуже (от bad)|wq:s
worship|культ, поклонение|'wq:SIp
worshiped|поклонялся, почитал (от worship)|
worshiper|поклонник|
worshiping|поклонение, поклоняющийся (от worship)|
worst|наихудший, самый плохой, хуже всего|wq:st
worth|стоящий|wq:T
would|будет (от will)|wud
would like|хотел(и) бы|
wouldn't|не будет (от would not)|'wudnt
wound|рана, ранить|waund
wrap|упаковывать|rxp
wreck|крушение, авария, разбить, крушение (авария)|rek
wrinkle|морщина, морщить(ся)|'rINkl
wrist|наручный|rIst
write|писать|raIt
write down|написать, записывать|
write out|выписывать|
writer|писатель, автор|'raItq
written|написанный (от write)|'rItn
wrong|неправильный, не тот|rON
wrongly|неверно|
wrote|писал (от write)|rqut
yard|ярд, двор|jQ:d
yards|ярды (от yard)|
yeah|да|jeq
year|год|jq:
yearly|ежегодно|'jq:lI
years|годы (от year)|
yellow|желтый|'jelqu
yes|да|jes
yesterday|вчера|'jestqdI
yet|еще|jet
yield|уступать|ji:ld
yoghurt|йогурт|'jOgq(:)t
you|вы, ты|ju:d
you're|ты есть (от you are)|juq
you've|вы имеете (от you have)|
young|молодой|jAN
your|ваш, твой|jO:
yourself|сам, сами|jO:'self
youth|юность, молодежь|ju:T
zero|ноль|'zIqrqu
zest|интерес, удовольствие|zest
zip code|почтовый индекс|'zIpkqud
zipper|застежка-"молния"|'zIpq
zoo|зоопарк|zu:
