about|о, про, относительно; примерно, около; вокруг, по|[q'baut]
above|выше, свыше, над, наверху|[q'bAv]
according (to)|согласно, в соответствии с|[q'kO:dIN] ([tu:])
across|поперек, через; на другой стороне|[q'krOs]
after|после; за; после того, как; в честь|['Q:ftq]
again|снова, опять|[q'(g)eIn]
against|против; об|[q'geInst]
ahead|вперед, впереди|[q'hed]
almost|почти|['O:lmoust]
along|вдоль, по; вместе|[q'lON]
already|уже|[O:l'redI]
also|также, тоже|['O:lsqu]
always|всегда|['O:lwqz]
among|среди|[q'mAN]
and|и; а|[xnd]
around|вокруг; около|[q'raund]
at|(место) в, на, у; (время) в|[xt]
at first|at first|[xt'fq:st]
at last|наконец|[xt lQ:st]
at least|по крайней мере|[xt lI:st]
at once|сразу, тотчас|[xt wAns]
away|прочь|[q'weI]
back|обратно|[bxk]
badly|плохо|[bxdlI]
because|потому что; из-за (of)|[bI'kOz]
before|перед, до, раньше, прежде чем, до того как|[bI'fO:]
behind|позади, за|[bI'haInd]
below|ниже, внизу|[bI'lou]
beneath|под; внизу|[bI'nI:T]
beside|рядом|[bI'saId]
besides|кроме, помимо|[bI'saIdz]
between|между|междумежду
beyond|за пределами, вне, по ту сторону|[bI'jOnd]
both...and|как,...так и|[bouT...xnd]
but|но, если не; кроме|[bAt]
but for|если бы не|[bAt fO:]
by|посредством, путем; (место) у, около, мимо; (время) к|[baI]
certainly|конечно, непременно|['sq:tnlI]
chiefly|главным образом|['tSI:flI]
clearly|ясно|['klIqlI]
close|близко|[klouz]
differently|иначе|['dIfr(q)ntlI]
directly|непосредственно|[dI'rektlI]
down|вниз, вниз по|[daun]
early|рано|['q:lI]
easy|легко|['I:zI]
either...or|или...или|['aIDq'O:]
else|еще, кроме|[els]
enough|довольно, достаточно|[I'nAf]
even|даже|['I:vn]
ever|когда-либо, когда-нибудь|['evq]
every|каждый|['evrI]
everybody|все|['evrIbOdI]
everyone|всякий|['evrIwAn]
everything|всё|['evrITIN]
except|исключая, кроме|[Ik'sept]
extremely|чрезвычайно|[Iks'trI:mlI]
far|далеко, далекий|[fa:]
farther|дальше (ср. far)|['fQ:Dq]
fast|быстро, скоро|[fQ:st]
few|мало, несколько|[fju:]
finally|наконец, в заключение|['faInqlI]
for|для, ради, за; в течение; ибо, так как|[fO:]
forever|навсегда|[fq'revq]
from|из; от, у|[frOm]
fully|вполне, совершенно, полностью|['fulI]
further|дальнейший; дальше, затем|['fq:Dq]
greatly|очень, весьма|['greItlI]
hard|тяжело, усиленно|[hQ:d]
here|здесь, сюда|[hIq]
hitherto|прежде, до сих пор|['hIDq'tu:]
however|(при наличии запятых в тексте) однако; (без запятых) как бы ни|[hau'evq]
ibid (ibidem)|там же|[I'baIdem]
if|если|[If]
immediately|немедленно, тотчас же|[I'mI:djqtlI]
in|(место) в; (время) через, в|[In]
in case|в случае; если|[InkeIs]
in order to|для того, чтобы|[In'O:dq'tu:]
including|включая, в том числе|[In'klu:dIN]
indeed|в самом деле, действительно|[In'd(I:)d]
inside|внутри, внутрь|['In'saId]
instead (of)|вместо; вместо того, чтобы|[In'sted] ([Ov])
into|в (на вопрос куда?, во что?)|['Intu]
just|как раз; именно; только что|[dZAst]
less|меньше|[les]
meanwhile|тем временем|['mI:n'waIl]
merely|только, просто|['mIqlI]
more|больше|[mO:]
moreover|кроме того, более того|[mO:'rouvq]
mostly|большей частью, главным образом|['moustlI]
much|много|[mAtS]
nearly|почти, около|['nIqlI]
neither...nor|ни...ни|['naIDq'nO:]
never|никогда|['nevq]
not yet|еще не|[not'jet]
nothing|ничто, нисколько|['nATIN]
now|теперь, сейчас|[nau]
nowhere|нигде, никуда|['nouweq]
of course|конечно|[Ov'kO:s]
often|часто, много раз|['Ofn]
on|(место) на; (время) в, по, после; о, относительно; вперед, дальше|[On]
on the spot|немедленно, на месте|[spOt]
once|один раз, однажды; когда-то; раз уж|[wAns]
one|один, некий, какой-то|[wAn]
only|только|['ounlI]
or|или|[O:]
out|вне, за, из; за пределами|['aut]
outside|снаружи, наружу|['aut'saId]
over|через, над; свыше|['ouvq]
particularly|особенно|[pq'tIkjulqlI]
partly|частично|['pQ:tlI]
past|после, за, мимо|[pQ:st]
per|по, через, посредством; за, на|[pq:]
perhaps|может быть, возможно|[pq'hxps]
plenty (of)|множество, много; вполне, довольно|['plentI]
previously|(за)ранее|['prI:vjqslI]
probably|вероятно|['prObqblI]
provided|при условии, что|[pro'vaIdqd]
quite|совсем, вполне, совершенно|[kwaIt]
rather|довольно, довольно-таки|['rQ:Dq]
really|действительно, на самом деле|['rIqlI]
round|вокруг, за; кругом; обратно, назад|[raund]
same|такой же, тот же самый|[seIm]
secondly|во-вторых|['sekqndlI]
seldom|редко|['seldqm]
several|несколько|['sevrql]
simply|просто|['sImplI]
since|с, с момента, с тех пор как; поскольку|[sIns]
so|так; также, тоже|[sou]
so as, so that|чтобы, с тем чтобы; так чтобы|[sou'xz], [sou'Dxt]
soon|вскоре, скоро|[su:n]
still|все еще; но все же|[stIl]
straight|прямо|[streIt]
than|чем|[Dxn]
that|тот, та, то; это; который, кто; что; то, что|[Dxt]
the...the|чем...тем|[Dq...Dq]
then|потом, затем, тогда|[Den]
therefore|поэтому, следовательно|['DеqfO:]
though (although)|хотя|[Dqu] ([O:l'Dqu])
through|через, внутри, по, сквозь, насквозь|[Tru:]
thus|так, таким образом; так, например|[DAs]
till (until)|до, (до тех пор) пока не|[tIl] ([qn'tIl])
to|к, в, на (на вопрос "куда?")|[tu:, tu, tq]
to be over|окончиться|[tu'bI'ouvq]
to be through; throughout|по всему, во всем|[tu'bI'Tru:]; [Tru:'aut]
toward(s)|к, по направлению|[tq'wO:dz]
under|под; при; на основании|['Andq]
unless|если...не|[qn'les]
until (till)|до, (до тех пор) пока не|[qn'tIl] ([tIl])
up|вверх, вверх по|[Ap]
upon (on)|(место) на; (время) в, по, после; о, относительно; вперед, дальше|[q'pOn]
what|что; то, что; какой|[wOt]
whether|ли|['weDq]
while|пока; несмотря на то, что; хотя; тогда как|[waIl]
with|с, со|[wID]
within|в пределах; в течение|[wI'DIn]
without|без|[wI'Daut]
yet|все же, однако; еще, все еще|[jet]
