"East of Suez" policy|политика "к востоку от Суэца"|
"guilty" verdict|вердикт "виновен"|
... hour week|... часовая неделя|
10 a year|10 в год|
10 pounds a week|10 фунтов в неделю|
3-week|трехнедельный|
5-day|5-дневный|
6-day visit|шестидневный визит|
Air Force|военно-воздушные силы|'Fq'fO:s
Amalgamated Engineering Union|объединенный профсоюз машиностроителей|
Amalgamated Union of Engineering Workers|объединенный профсоюз машиностроителей|
Antiques Fair|ярмарка антикварных предметов|
Appeal Court|апелляционный суд|
Archbishop of Canterbury|архиепископ Кентерберийский|
Atomic Energy Authority|Управление по атомной энергии|
Attorney General|министр юстиции|
Board of Trade|министерство торговли|
British entry|вступление Англии в "Общий рынок"|
British parliament|британский парламент|
British people|британцы|
CIA agent|агент ЦРУ|
CS gas|газ "Си-Эс"|
Cabinet minister|министр, входящий в состав кабинета|
Central Intelligence Agency (CIA)|Центральное разведывательное управление (ЦРУ)|
Chancellor of the Exchequer|министр финансов|
Chief Constable|начальник полиции|
Chief Executive|президент|
Civil Aviation Authority|Управление гражданской авиацией|
Coal Board|министерство угольной промышленности|
College of Education|педагогический колледж|
Committee of inquiry|комиссия по расследованию|
Common Market countries|страны "Общего рынка"|
Common market|"Общий рынок"|
Commonwealth of Independent States|содружество независимых государств|
Communist MP|коммунист-член парламента|
Communist Party|коммунистическая партия|
Communist Party leader|руководитель коммунистической партии|
Communist candidate|кандидат от коммунистов|
Communist councillor|член муниципалитета-коммунист|
Communist movement|коммунистическое движение|
Conservative Party|консервативная партия|
Consumer Council|совет потребителей|
Council for Scientific Policy|совет по делам науки|
Council of Churches|совет церквей|
County Council|совет графства|
Court of Appeal|апелляционный суд|
Crown Court|коронный суд|
Customs staff|служащие таможни|
Defence Minister|министр обороны|
Defence Secretary|министр обороны|
Department of Education and Science|департамент просвещения и науки|
Department of Employment|министерство по вопросам занятости|
Department of Health|министерство здравоохранения|
Deputy Premier|заместитель премьер-министра|
EEC regulations|правила ЕЭС|
Economics Minister|министр экономики|
Education Secretary|министр просвещения|
Electrical Trades Union|профсоюз электротехников|
Electricity Board|министерство электроэнергетики|
Electricity Council|совет по электричеству|
Employment Minister|министр по вопросам занятости|
Employment Secretary|министр по вопросам занятости|
Energy Secretary|министр энергетики|
Environment Minister|министр по вопросам окружающей среды|
European Community|Европейское сообщество|
European parliament|европейский парламент|
European security|европейская безопасность|
Federation of Trades Councils|федерация профсоюзов|
Football Association|Футбольная ассоциация|
Foreign Minister|министр иностранных дел|
Foreign Ministry spokesman|представитель министерства иностранных дел|
Foreign Office|министерство иностранных дел|
Foreign Secretary|министр иностранных дел|
General Council|генеральный совет|
General Election|всеобщие выборы|
Geneva Agreements|Женевские соглашения|
Government Minister|министр правительства|
Government aid|правительственная помощь|
Government department|правительственный департамент|
Health Service|управление здравоохранения|'helT'sq:vIs
Health Service charges|плата за медицинское обслуживание|
High Court|Высокий суд|'haI'kO:t
Home Office|министерство внутренних дел|
Home Secretary|министр внутренних дел|
House of Commons|палата общин|
House of Lords|палата лордов|
Housing Executive|комитет жилищно-строительной ассоциации|
Industrial Relations Act|закон об отношениях в промышленности|
Industry Secretary|министр промышленности|
Inland Revenue|управление налоговых сборов|
Interior Minister|министр внутренних дел|
Lab-Lib pact|договор между лейбористской и либеральной партиями|
Labour Club|клуб лейбористов|
Labour Government|лейбористское правительство|
Labour MP|лейборист-член парламента|
Labour Party|лейбористская партия|'leIbq'pQ:tI
Labour Party leader|лидер лейбористской партии|
Labour Party member|член лейбористской партии|
Labour candidate|кандидат от лейбористов|
Labour council|лейбористский муниципалитет|
Labour councillor|член муниципалитета-лейборист|
Labour group|лейбористская группа|
Labour leader|лидер лейбористской партии|
Labour people|лейбористы|
Labour supporter|сторонник лейбористов|
Left Labour MP|левый лейборист-член парламента|
Left Wing|левое крыло|
Left Winger|представитель левого крыла|
Liberal MP|член парламента от либеральной партии|
Liberal Party|партия либералов|
Liberal leader|лидер партии либералов|
Lord Chief Justice|лорд-главный судья|
Lord Mayor|лорд-мэр|'lO:d'mFq
MP (Member of Parliament) for|член парламента от|
Market membership|участие в "Общем рынке"|
May Day|Первое мая|'meIdeI
Medical Association|Ассоциация медицинских работников|
Metropolitan Police|лондонская полиция|
Minister of Aviation|министр авиации|
Minister of Health|министр здравоохранения|
Minister of Industry|министр промышленности|
Minister of Justice|министр юстиции|
Minister of Labour|министр труда|
Minister of State|государственный министр|
Ministry of Defence|министерство обороны|
Ministry of Labour|министерство труда|
Ministry of Transport|министерство транспорта|
NF march|демонстрация Национального фронта|
National Assembly|Национальное собрание|
National Coal Board|министерство угольной промышленности|
National Combine|национальное объединение|
National Committee|национальный комитет|
National Executive Committee|Национальный исполнительный комитет|
National Front|Национальный фронт|
National Front supporter|сторонник Национального фронта|
National Health Service|государственная служба здравоохранения|
National Liberation Front|Национальный фронт освобождения|
National Plan|государственный план|
National Union of Journalists|Национальный союз журналистов|
National Union of Mineworkers|Национальный профсоюз горняков|
National Union of Public Employees|Национальный профсоюз общественных работников |
National Union of Railwaymen|Национальный профсоюз железнодорожников|
National Union of Teachers|Национальный союз учителей|
Nationalist Party|националистические партии|
New Year|Новый год|'nju:'jq:
News agency|информационное агентство|'nju:z,eIdZqnsI
North-East|северо-восток|
North-West|северо-запад|
Official Secrets Act|закон о государственной тайне|
Opposition MP|член парламента от оппозиции|
Palestine Liberation Organization|Организация освобождения Палестины|
Parliamentary Labour Party|парламентская группа партии лейбористов|
Parliamentary candidate|кандидат в парламент|
Party conference|партийная конференция|
Patriotic Front|Патриотический фронт|
Peace Committee|Комитет сторонников мира|
Pentagon paper|секретные документы Пентагона|
Permanent Secretary|постоянный заместитель министра|
Police Authority|полицейское управление|
Post Office Engineering Union|профсоюз технических работников почт|
Post Office chairman|председатель управления почт и телеграфа|
Post Office spokesman|представитель министерства почт|
Press Council|совет по делам печати|
Prices and Incomes Act|закон о ценах и доходах|
Prices and Incomes Board|министерство цен и доходов|
Prime Minister|премьер-министр|
Provisional IRA|Временная ирландская республиканская армия|
Public Order Act|закон об общественном порядке|
Public Service Union|профсоюз работников общественного обслуживания|
Race Relations Act|закон о расовых отношениях|
Railways Board|министерство железных дорог|
Rent Act|закон об арендной плате|
Republican Club|клуб республиканцев|
Right Wing|правое крыло|
Right Winger|представитель правого крыла|
Roman Catholic|католик|'rqumqn'kxTqlIk
Royal Navy|королевский военно-морской флот|
Saturday night|в субботу вечером|
Scotland Yard|Скотленд-ярд|'skOtlqnd'jQ:d
Secretary of State|государственный секретарь|
Secretary of State for Scotland|государственный секретарь по делам Шотландии|
Security Council|Совет Безопасности|sI'kjuqrItI'kaunsl
Select Committee|специальный комитет|
Senate Foreign Relations Committee|сенатская комиссия по иностранным делам|
Shadow Cabinet|"теневой кабинет"|'Sxdqu'kxbInIt
Social Democratic Party|социал-демократическая партия|
Social Security Office|ведомство социального обеспечения|
Social Service Minister|министр общественных работ|
South-East|юго-восток|'sauT'i:st
South-West|юго-запад|'sauT'west
Special Patrol Group|специальные патрульные отряды|
State Department|государственный департамент|
Stock Exchange|фондовая биржа|'stOkIks,tSeIndZ
Supreme Court|Верховный суд|
TUC General Council|Генеральный совет БКТ|
TUC leader|лидер БКТ|
TV programme|телевизионная программа|
Thursday night|в четверг вечером|
Tory Cabinet|кабинет, сформированный консерваторами|
Tory Council|муниципалитет, возглавляемый консерваторами|
Tory Government|правительство консерваторов|
Tory MP|консерватор-член парламента|
Tory Party|партия консерваторов|
Tory attack|нападки со стороны консерваторов|
Tory bill|представленный консерваторами законопроект|
Tory candidate|кандидат от консерваторов|
Tory central Office|центральный совет консервативной партии|
Tory ladies|представительницы партии консерваторов|
Tory leaders|лидеры партии консерваторов|
Tory majority|консервативное большинство|
Tory manifesto|предвыборный манифест консерваторов|
Tory policy|политика партии консерваторов|
Tory victory|победа консерваторов на выборах|
Trade Minister|министр торговли|
Trade Union Centre|профсоюзный центр|
Trade Union Congress|Британский конгресс тред-юнионов|
Trades Council|объединение профсоюзов|
Transport Workers' Union|профсоюз работников транспорта|
Transport union|профсоюз работников транспорта|
Treaty of Rome|Римский договор|
Tribune MP|член парламента от группы "Трибуна"|
US troops|американские войска|
Ulster Volunteer Force|добровольческие отряды Ольстера|
Union of Post Office Workers|профсоюз почтовых работников|
United Nations|Организация Объединенных Наций|ju:'naItIdA'neISqnz
United States|Соединенные Штаты|
University chief|глава университета|
Wednesday night|в среду вечером|
Welfare State|"государство всеобщего благоденствия"|
White House|Белый дом|'waIt'haus
White Paper|"Белая книга"|'waIt'peIpq
Working Party|партия трудящихся|
World Cup|приз мирового чемпионата|
a bit|немного|
a cause of|дело|
a day|в день|
a day after|день спустя после того, как|
a few|немногие|
a good deal of|много|
a great deal of|очень много|
a little|немного|
a lot of|много|
a matter of something|дело чего-либо|
a number of|несколько|
a part of something|часть чего-либо|
a range of something|ряд чего-либо|
a select few|немногие "избранные"|
a series of something|ряд|
a sort of|нечто вроде|
a total of|сумма|
able seaman|матрос|
able to do something|способный сделать что-либо|
above all|главным образом|
absent from|отсутствующий в|
according to|в соответствии с|
account for something|объяснять что-либо|
account of|отчет о|
accuse somebody of something|обвинять кого-либо в чем-либо|
act as|действовать как|
action against|действия против|
action by|действия|
action on|влияние на|
add fuel to the fire|подливать масла в огонь|
add that|добавлять, что|
add to|добавлять к|
adhere to something|твердо держаться чего-либо|
admit that|признавать, что|
advisory committee|консультативный комитет|
affiliated to|принятый в|
after all|в конце концов|
against a background|на фоне|
agree on|договориться о|
agree that|признавать, что|
agree to|согласиться на|
agree to do something|согласиться сделать что-либо|
agree with|согласиться с|
agreement on|соглашение о|
agreement with|соглашение с|
aid to somebody|помощь кому-либо|
aim against|нацеливаться против|
aim at|нацеливаться на|
aim for|стремиться к|
aim to do something|стремиться сделать что-либо|
air support|поддержка с воздуха|
aircraft industry|авиационная промышленность|
all concerned|все заинтересованные|
all over the country|по всей стране|
allegation against|заявление против|
allegation of|объединение в|
allege that|утверждать, что|
allied to|связанный с|
allow for|учитывать|
along with|вместе с|
ambassador to|посол в|
amount of|количество|
amount to|составлять|
ancillary workers|вспомогательный персонал|
and so on|и так далее|
announce that|объявлять, что|
annual conference|ежегодная конференция|
annual report|ежегодный отчет|
another|еще|q'nADq
answer a question|отвечать на вопрос|
answer to|ответ на|
anti-Nazi league|антифашистская лига|
anti-union bill|антипрофсоюзный законопроект|
anti-union legislation|антипрофсоюзное законодательство|
any of|любой из|
anywhere else|где бы то ни было еще|
apart from|кроме того что|
apartheid police|полиция режима апартеида|
apartheid regime|режим апартеида|
appeal against|воззвание против|
appeal for|призыв о|
appeal to|взывать к|
appeal to do something|призыв сделать что-либо|
appear at court|предстать перед судом|
appear in court|являться в суд|
application for|заявление о|
apply for|подавать заявление о|
apply to|применять к|
apply to do something|подавать заявление о том, чтобы было сделано что-либо|
approach to|подход к|
argue that|доказывать, что|
arise from|проистекать|
armed forces|вооруженные силы|
arms bill|законопроект о расходах на вооружение|
arms production|производство оружия|
arms race|гонка вооружений|
arms sales|продажа оружия|
army officer|армейский офицер|
arrest somebody for something|арестовывать кого-либо за что-либо|
arrive at|прибыть в|
art gallery|художественная галерея|
as a consequence|вследствие|
as a result|как результат|
as a result of something|в результате чего-либо|
as a whole|в целом|
as far|до|
as if|как если бы|
as little as|так же мало|
as long as|пока|
as much as|почти на столько же|
as regards|что касается|
as soon as|как только|
as soon as possible|как можно скорее|
as such|как таковой|
as to|относительно|
as well|а также|
as well as|также|
as yet|пока еще не...|
as...as|так же ...как|
as...as possible|насколько возможно|
ask for something|просить что-либо|
ask somebody to do something|просить кого-либо сделать что-либо|
assault on|нападение на|
assistant general secretary|помощник генерального секретаря|
assistant secretary|помощник секретаря|
associated with|ассоциирующийся с|
at a stroke|одним махом|
at a time|за раз|
at all|вообще|
at first|сперва, сначала|
at high level|на высоком уровне|
at home|дома|
at large|подробно|
at last|наконец|
at least|по крайней мере|
at once|сразу|
at present|в настоящее время|
at the beginning|в начале|
at the beginning of the current year|в начале этого года|
at the end of|в конце|
at the expense of|за счет|
at the latest|самое позднее|
at the moment|в настоящий момент|
at the present time|в настоящее время|
at the rate of|по курсу|
at the request|по запросу|
at the same time|в то же время|
at the time|в то время|
at the time of|во время|
at the top of|в верхней части|
at work|за работой|
at...rate|в ... темпе|
attack on|нападки на|
attempt to do something|попытка сделать что-либо|
attitude to|отношение к|
attitude towards|отношение к|
award damages|возмещать убытки|
back up|поддерживать|
balance of payments|баланс платежей|
ballot for|голосование за|
ballot on|голосование по вопросу|
ban on something|запрещение чего-либо|
bank holiday|официальный выходной день|
bank rate|учетная ставка банка|
based on|основанный на|
basic wage|основная заработная плата|
basis rate|основная ставка|
battle for|бороться за|
battle to do something|борьба с целью добиться чего-либо|
be a part of|быть частью|
be about to do something|быть в состоянии делать что-либо|
be afraid of|бояться|
be against|выступать против|
be angry that|сердиться, что|
be aware of|сознавать|
be away|отсутствовать|
be concerned about|беспокоиться о|
be concerned that|беспокоиться, что|
be concerned with|интересоваться|
be designed to do something|предназначаться для совершения чего-либо|
be due to do something|быть должным сделать что-либо|
be due to something|быть вызванным чем-либо|
be going to do something|собираться сделать что-либо|
be in charge|заведовать|
be in progress|происходить|
be in the way of|мешать|
be made of|быть сделанным из|
be of the opinion that|считать, что|
be on guard|быть настороже|
be on strike|бастовать|
be on way to|быть на пути к|
be over|кончаться|
be subject to|подлежать|
be the first to do something|быть первым в осуществлении|
be to blame for|нести ответственность за|
be unaware of|не знать о|
be up|закончиться|
be up to|зависеть от|
be worth doing something|быть достойным сделать что-либо|
bear in mind|иметь в виду|
beat up|зверски избивать|
because of|из-за|
become law|стать законом|
begin with|начинать с|
believe in|верить в|
believe that|верить, что|
belong to somebody|принадлежать кому-либо|
benefit from|получать пользу от|
between...and|от...до|
bid to do something|предлагать сделать что-либо|
big business|крупный капитал|
black American|американский негр|
black out|вычеркивать|
black people|негры|
black prisoner|заключенный негр|
blow to|удар по|
blow up|взрывать|
bodily injures|телесные повреждения|
book seats|заказывать места|
borough council|городской муниципалитет|
both...and|не только...|
bound to do something|обязанный сделать что-либо|
branch secretary|секретарь отделения|
break down|сломать|
break even|окончиться безубыточно|
break in|врываться|
break out|разразиться|
break the law|нарушать закон|
break up|разбивать|
break with|порвать отношения|
bring about|вызывать|
bring back|возвращать|
bring forward|выдвигать|
bring forward to|перенести на|
bring in|вводить|
bring into|ввести в|
bring out|высказывать|
bring somebody to do something|заставлять кого-либо сделать что-либо|
bring to an end|довести до конца|
bring up|выдвигать|
broad mass movement|движение широких масс|
build up|строить|
building site|строительная площадка|
building society|ассоциация строителей|
building worker|строительный рабочий|
bus service|автобусное сообщение|
by means of|посредством|
by no means|никоим образом|
by votes to|голосами против|
call for something|призыв к чему-либо|
call from|призыв|
call in|впускать|
call off|отзывать|
call on|призывать|
call out|вскрикнуть|
call to do something|призыв сделать что-либо|
call to somebody|призыв к кому-либо|
call upon|предоставлять слово|
campaign against|кампания против|
campaign for|кампания за|
campaign to do something|кампания за осуществление чего-либо|
candidate for|кандидат на|
capable of|способный к|
capital investment|капиталовложение|
car worker|рабочий автомобильного завода|
card vote|голосование делегатов|
care to do something|утруждать себя выполнением чего-либо|
careers officer|служащий отдела кадров|
carry on|продолжать|
carry out|выполнять|'kxrI 'aut
carry through|доводить до конца|
cast votes|отдавать голоса|
censure motion|предложение о недоверии|
central committee|центральный комитет|
centre ground|центральный участок|
centre on|концентрировать на|
chain gang|группа каторжников в кандалах|
champion of|борец за|
change in|изменение в|
charge against|обвинение против|
charge of|обвинение в|
charge that|обвинение в том, что|
charge with something|обвинять в чем-либо|
chief negotiator|глава делегации на переговорах|
child care|забота о детях|
choose to do something|решить сделать что-либо|
city centre|центр города|
city council|муниципалитет|
city hall|ратуша|
civil liberties|гражданские свободы|
civil rights|гражданские свободы|'sIvl 'raIts
civil servant|государственный служащий|
civil service|государственная служба|
civil war|гражданская война|
claim for something|требование чего-либо|
claim that|требование того,  чтобы|
class struggle|классовая борьба|
clear the backlog|ликвидировать отставание|
clerical worker|канцелярский работник|
close to|близко к|
closed shop|"закрытое предприятие"|
co-operate with|сотрудничать с|
co-operative movement|кооперативное движение|
coal industry|угольная промышленность|
coincide with|соответствовать|
cold war|холодная война|
collective bargaining|заключение коллективных договоров|
colour film|цветной фильм|'kAlq'fIlm
coloured man|"цветной"|
coloured people|"цветные"|
coloured worker|"цветной" рабочий|
combine committee|объединенный комитет|
come back|возвращаться|
come down|спускаться|
come from|происходить из|
come in|входить|
come into|входить в|
come into force|вступать в силу|
come out|выходить|
come out for|выступать за|
come to conclusion|прийти к выводу|
come up|подниматься|
coming year|наступающий год|
commander-in-chief|главнокомандующий|kq'mQ:ndqrIn'tSi:f
comment on|высказывание по поводу, высказываться по поводу|
commit for trial|предать суду|
commit suicide|совершать самоубийство|
commit to something|подвергать чему-либо|
commitment to somebody|передача кому-либо|
community relations|отношения в обществе|
company director|один из директоров компании|
compare with|согласоваться с|
compared with|по сравнению с|
complain of|жаловаться на|
complaint about|жалоба о|
complaint against|жалоба на|
complaint from|жалоба от|
comprehensive school|единая школа|
concentrate on|концентрироваться на|
concentration camp|концентрационный лагерь|
conclude that|заключать, что|
condemn as|осуждать как|
conditions for|условия для|
conference decision|решение конференции|
conference resolution|резолюция конференции|
confident that|уверенный в том, что|
confirm that|подтвердить, что|
confrontation with|конфронтация с|
connected with|связанный с|
consider that|считать, что|
consist of|состоять из|
conspiracy charge|обвинение в заговоре|
conspiracy to do something|заговор с целью совершить что-либо|
constituency party|партийная организация избирательного округа|
consult about|советоваться о|
consultation with|консультация с|
consumer protection|защита интересов потребителя|
contrary to|против|
contribute to|способствовать|
contribution to|вклад в|
control on|контроль над|
convene a conference|созывать конференцию|
convince that|убеждать в том, что|
cope with|справляться с|
corned beef|солонина|
corporation tax|налог на корпорации|
cost of living|стоимость жизни|
council houses|дома, принадлежащие муниципалитету|
council houses sales|распродажа муниципальных домов|
council tenant|жилец муниципального дома|
coupled with|вместе с|
court of inquiry|следственная комиссия|
create jobs|создавать рабочие места|
criminal damage|ущерб, нанесенный с преступной целью|
criminal offence|уголовное преступление|
critical of|критикующий|
criticism of|критика в адрес|
cross the picket line|нарушить пикетирование|
current issue|текущая проблема|
current trends|современные тенденции|
cut back|сокращать|
cut by|сократить на|
cut down|сократить|
cut off|прерывание|
cut out|отказаться от|
cuts in|сокращение на|
damage to somebody|ущерб кому-либо|
danger to|угроза|
dangerous to|угрожающий|
date for|день, на который назначено что-либо|
day-to-day|повседневный|'deItq'deI
deal with|иметь дело с|
death penalty|смертная казнь|
death sentence|смертный приговор|
debate on|прения по|
decide on|решиться на|
decide to do something|решить сделать что-либо|
decision by|решение|
decision on|решение о|
decision to do something|решение сделать что-либо|
declare that|заявить, что|
decrease in something|уменьшение чего-либо|
defeat the bill|провалить законопроект|
defence expenditure|расходы на оборону|
defence lawyer|защитник|
defence of|защита|
delay in|задержка|
delegate from|делегат от|
delegate to|делегат на|
demand for|требование о|
demand that|требование|
demands by|требования|
democratic centralism|демократический централизм|
democratic movement|демократическое движение|
democratic rights|демократические права|
demonstration against|демонстрация протеста против|
demonstration massive|массовая демонстрация|
denounce as|разоблачать как|
deny something to somebody|отказывать в чем-либо кому-либо|
deny that|отрицать, что|
depend on|зависеть от|
dependence on|зависимость от|
dependent on|зависимый от|
deprive of something|лишать чего-либо|
deputy chairman|заместитель председателя|
deputy editor|заместитель редактора|
deputy general secretary|заместитель генерального секретаря|
detention centre|лагерь для интернированных|
die of|умереть от|
different from|отличный от|
direct at|направлять на|
direct elections|прямые выборы|
director-general|генеральный директор|
discussion of|обсуждение|
discussion on|дебаты по вопросу о|
dispute over|спор о|
dissatisfaction with|недовольство|
dissociate from|отмежеваться от|
district committee|районный комитет|
district council|окружной муниципальный совет|
district secretary|секретарь районной организации|
divert from|отвлекать от|
do one's best|делать все возможное|
draw attention to|привлечь внимание к|
draw conclusion from|сделать вывод из|
draw up|составлять|
draw up a plan|составлять план|
drive into|загнать в|
drive to|выехать в|
drop in something|снижение чего-либо|
due to|благодаря|
each other|друг друга|
earlier this month|в начале этого месяца|
early yesterday|вчера утром|
east of|к востоку от|
economic committee|экономическая комиссия|
economic measures|экономические меры|
economic policy|экономическая политика|
economic problems|экономические проблемы|
education authorities|органы просвещения|
effect on|влияние на|
effect on something|влияние на что-либо|
effort by|усилия со стороны|
effort on|усилия относительно|
election campaign|предвыборная кампания|
election manifesto|предвыборный манифест|
election time|время выборов|
election tricks|махинации во время выборов|
electric chair|электрический стул|I'lektrIk'tSFq
electricity supply worker|работник службы обеспечения электроэнергией|
emergency resolution|чрезвычайное решение|
emphasis on something|подчеркивание чего-либо|
end to|прекращение|
end up|оканчиваться|
energy crisis|энергетический кризис|
engineering industry|машиностроение|
engineering section|секция машиностроителей|
engineering shop steward|цеховой староста машиностроителей|
engineering union|профсоюз машиностроительных рабочих|
engineering worker|рабочий машиностроительной промышленности|
engineers union|профсоюз механиков|
ensure that|обеспечивать, что|
enter into|вступать в|
entry into|вход в|
entry to|вход в|
equal pay|равная оплата труда|
equal to something|равный чему-либо|
equivalent to something|эквивалентный чему-либо|
essential service|важная услуга|
even though|даже если|
ever since|с тех пор|
every right|все права|
evict from|выселять из|
evidence from somebody|показания кого-либо|
evidence of something|свидетельство чего-либо|
evidence that|свидетельство того, что|
evidence to something|свидетельство относительно чего-либо|
except for|кроме|
excessive profit|сверхприбыли|
executive committee|исполнительный комитет|
executive council|исполнительный комитет|
executive member|член исполнительного комитета|
explain that|объяснить, что|
express concern|выражать озабоченность|
extend to|распространить на|
extra payment|дополнительная выплата|
eye-witness|свидетель чего-либо|
face up to|быть готовым к|
face with|столкнуться с|
factory convener|заводской уполномоченный|
fail to do something|потерпеть неудачу в попытке сделать что-либо|
failure to do something|неудача в попытке сделать что-либо|
fair rent|справедливый размер квартирной платы|
fall in something|понижение чего-либо|
family allowances|пособия многосемейным|
far from|далеко не|
far more|гораздо больше|
fast reactor|реактор на быстрых нейтронах|
fear of|страх перед|
fear that|бояться, что|
feel sure|чувствовать уверенность|
fight against|борьба против|
fight for|борьба за|
fight to do something|борьба за осуществление чего-либо|
fighter-bomber|истребитель-бомбардировщик|
fighting fund|фонд борьбы|
figures on|цифры о|
financial burden|финансовое бремя|
financial institution|финансовое учреждение|
find guilty of|признать виновным в|
find out|выяснить|
fire brigade|пожарная команда|
fire shots|стрелять|
first of all|прежде всего|
five-year plan|пятилетний план|
fly in|влететь|
focal point|фокус|
follow up|преследовать|
food prices|цены на продукты питания|
food scientist|специалист в области питания|
for a long time|в течение долгого времени|
for example|например|
for instance|например|
for somebody to do something|чтобы кто-либо сделал что-либо|
for the first time|впервые|
for this reason|по этой причине|
for...reason|по причине|
force somebody to do something|вынуждать кого-либо сделать что-либо|
force something on somebody|навязывать что-либо кому-либо|
foreign affairs spokesman|представитель министерства иностранных дел|
foreign policy|внешняя политика|
free from|освобождать из|
free milk|бесплатное молоко|
free of|свободный от|
free school milk|бесплатное молоко в школе|
free speech|свобода слова|
freedom for|свобода для|
freedom of speech|свобода слова|
from all over the country|со всех концов страны|
from now|с настоящего времени|
front page|первая страница|'frAntpeIdZ
full-scales|в полном масштабе|
full-time|штатный|
full-time official|штатный служащий|
full-time union official|освобожденный профсоюзный работник|
general election campaign|всеобщая предвыборная кампания|
general secretary|генеральный секретарь|
general strike|всеобщая забастовка|
get away with|избежать, сделать незаметно|
get back|вернуть|
get out|выходить|
get out of|покинуть|
get rid of|избавиться от|
get somebody to do something|заставить кого-либо делать что-либо|
get together|собирать|
give details|рассказывать подробности|
give evidence|давать показания|
give example|подавать пример|
give notice|предупреждать официальным извещением|
give opportunity|давать возможность|
give power to|давать полномочия|
give priority to|отдавать преимущество|
give support to|оказывать поддержку|
give way|податься|
go ahead|двигать вперед|
go ahead with|продолжать|
go back|возвращаться, возвращаться к|
go in|входить|
go in for|участвовать|
go into|вступать|
go off|взрываться|
go on|продолжать|
go on strike|бастовать|
go out|выходить|
go through|пройти|
go up|подниматься|
government action|правительственные действия|
government body|правительственное учреждение|
government cuts|правительственные сокращения|
government grants|правительственные субсидии|
government measures|правительственные меры|
government policy|правительственная политика|
grammar school|средняя классическая школа|
gross national product|валовой продукт страны|
grounds for|основания для|
growth rate|темп роста|
guilty of|виновный в|
half a million|полмиллиона|
halt to|прекращение|
hand in|вручать|
hand out|раздавать|
hand over|передавать|
happen to|случиться с|
hard time|трудное время|
have effect on|оказывать влияние на|
have in mind|иметь в виду|
have right to do something|иметь право делать что-либо|
have to do something|быть должным делать что-либо|
hear of|слышать о|
higher education|высшее образование|
hit at|нанести удар по|
hit out|наносить удары|
hive off|денационализировать|
hold a conference|проводить конференцию|
hold back|сдерживать|
hold ballot|проводить голосование|
hold down|держать в подчинении|
hold election|проводить выборы|
hold meeting|проводить митинг|
hold talks|проводить переговоры|
hold up|поддерживать|
hold wages down|сдерживать рост заработной платы|
home market|внутренний рынок|
hospital worker|работник больницы|
house building|жилищное строительство|
housing policy|политика в области жилищного строительства|
how many|сколько|
how much|сколько|
hunger strike|голодная забастовка|
idea that|идея, что|
identify with|отождествлять с|
illegal regime|незаконный режим|
immigrant woman|иммигрантка|
immigrant worker|рабочий-иммигрант|
immigration bill|законопроект об иммиграции|
immigration officer|представитель иммиграционных властей|
import control|контроль над импортом|
impose on|налагать на|
in a meantime|между тем|
in accord with|в соответствии с|
in accordance with|согласно|
in action|в действии|
in addition to|кроме того|
in advance|заранее|
in all|всего|
in an attempt|в попытке|
in an effort to do something|в попытке сделать что-либо|
in any case|во всяком случае|
in breach of|в нарушение|
in case of|в случае|
in connection with|в связи с|
in detail|детально|
in effect|в сущности|
in exchange for|в обмен на|
in fact|действительно|
in favour of|в пользу|
in full|целиком|
in general|вообще|
in line with|в согласии с|
in office|находящийся у власти|
in order that|чтобы|
in order to|чтобы|
in other words|другими словами|
in particular|в частности|
in place of|вместо|
in practice|на практике|
in principle|в принципе|
in private hands|в частном владении|
in protest against|в знак протеста против|
in public|публично|
in real terms|реально|
in recent years|за последние годы|
in regard to|относительно|
in relation to|относительно|
in respect of|что касается|
in response to|в ответ на|
in return|взамен|
in return for something|взамен чего-либо|
in short|короче говоря|
in some cases|в некоторых случаях|
in spite of|несмотря на|
in support of somebody|в поддержку кого-либо|
in terms of|в терминах|
in the course of|в течение|
in the early seventies|в начале 70-х годов|
in the end|наконец|
in the event of|в случае|
in the face of|перед лицом|
in the first instance|прежде всего|
in the interests of|в интересах|
in the light of|в свете|
in the long run|в конце концов|
in the midst of|посреди|
in the national interests|в национальных интересах|
in the past|в прошлом|
in the wake of|по пятам|
in this respect|в этом отношении|
in this way|таким образом|
in time|вовремя|
in turn|в свою очередь|
in view|на взгляд|
in view of|ввиду|
in way|каким-либо образом|
income tax|подоходный налог|
incomes policy|политика в области доходов|
increase by|увеличить на|
increase in something|увеличение чего-либо|
increases of|рост на|
industrial action|забастовочные действия|
industrial action against|забастовочные действия против|
industrial correspondent|промышленный корреспондент|
industrial democracy|демократическая политика в отношениях промышленности|
industrial dispute|трудовой конфликт|
industrial exhibition|промышленная выставка|
industrial relations|отношения в промышленности|
industrial relations bill|законопроект об отношениях в промышленности|
industrial relations reform|реформа отношений в промышленности|
inform of|информировать о|
inquiry by the police into something|расследование полицией чего-либо|
inquiry into something|расследование чего-либо|
insist on|настаивать на|
insist that|настаивать, что|
instead of|вместо|
insult to somebody|оскорбление кому-либо|
interest rate|процентная ставка|
interested in|заинтересованный в|
interim report|предварительный доклад|
interim report on|предварительный доклад о|
internal democracy|внутрипартийная демократия|
introduce a policy|вводить политику|
invest in|помещать капитал в|
investigation into|расследование|
investment in|вклад в|
involve in|вовлечь в|
irrespective of|вне зависимости от|
it comes to|доходит до|
it is clear that|ясно, что|
it is essential that|важно, чтобы|
it is necessary to do something|необходимо сделать что-либо|
it is obvious that|очевидно, что|
it is time|пора|
it is understood that|считают, что|
it is...that|именно тот|
it looks like|похоже на|
jail for|заключать в тюрьму на|
join in|присоединяться к|
join up|поступать на военную службу|
join with|присоединяться к|
joint campaign|совместная кампания|
just think|подумать только|
keep down|подавлять|
keep off something|удерживать от чего-либо|
keep out|держать в стороне|
keep quiet|сохранять тайну|
keep somebody out of|уберечь кого-либо от|
keep something down|подавлять что-либо|
keep something open|держать открытым|
keep something up|поддерживать что-либо|
kind of|(какого-либо)рода|
know of|знать о|
labour and trade union movement|рабочее и профсоюзное движение|
labour force|рабочая сила|
labour legislation|трудовое законодательство|
labour movement|рабочее движение|
lack of something|отсутствие чего-либо|
large-scales|в широких масштабах|
last February|в феврале прошлого года|
last March|март прошлого года|
last November|в ноябре прошлого года|
last Saturday|в прошлую субботу|
last Thursday|в прошлый четверг|
last month|в прошлом месяце|
last night|вчера вечером|
last summer|прошлым летом|
last week|на прошлой неделе|
last weekend|в прошлый выходной|
last year|в прошлом году|
launch a campaign|открыть кампанию|
launching site|стартовая позиция|'lO:ntSINsaIt
law and order|законность и порядок|
law on|закон о|
lay down|учреждать|
lay off|откладывать|
lay the basis for|закладывать основы|
lead to|приводить к|
learn from|извлечь урок из|
leave for|отправить в|
leave out|пропускать|
left to right|слева направо|
left unity|единство левых сил|
legal services|юридическая служба|
leisure centre|место для проведения досуга|
lending rates|кредитные ставки|
less then|меньше, чем|
let us do something|выражает побуждение|
letter from|письмо от|
letter to somebody|письмо кому-либо|
liable to something|подлежащий чему-либо|
liaison committee|консультативный комитет|
liberation forces|освободительные войска|
liberation movement|освободительное движение|
life sentence|приговор к пожизненному заключению|
limit on|ограничение на|
linked with|связанный с|
listen to something|слушать что-либо|
live on something|жить чем-либо|
living standard|жизненный уровень|
living wage|заработная плата|
lobby of Parliament|кампания давления на парламент|
local Labour Party|местная организация лейбористской партии|
local authorities|местные власти|
local authority employee|муниципальный работник|
local authority worker|муниципальный работник|
local council|местный муниципальный совет|
local government|местное самоуправление|
local people|местные жители|
lock out|объявлять локаут|
lock up|запереть|
long before|задолго до|
long-term|долгосрочный|'lONtq:m
look after|заботиться о|
look at|взгляд на|
look for|искать|
look forward to|предвкушать|
look into|заглянуть в|
lorry driver|водитель грузовика|
loss of jobs|потеря рабочих мест|
low pay|низкая оплата труда|
low-paid|низкооплачиваемый|'lqu'peId
lower-paid worker|низкооплачиваемый работник|
lowest-paid|самый низкооплачиваемый|
machine gun|пулемет|
magistrates court|мировой суд|
major party|крупнейшие партии|
majority rule|принцип большинства|
make a decision|принимать решение|
make a mockery of|высмеивать|
make a profit|получать прибыль|
make arrangements|организовывать|
make attempt to do something|пытаться сделать что-либо|
make clear that|пояснять, что|
make impossible|делать невозможным|
make it clear that|пояснять, что|
make it impossible to do something|помешать делать что-либо|
make matters worse|ухудшать положение дел|
make mention|упоминать|
make out that|понять|
make possible|делать возможным|
make progress|делать успехи в|
make somebody to do something|заставлять кого-либо делать что-либо|
make somethingclear|пояснять что-либо|
make up|составлять|
make use of|использовать|
managing director|управляющий|
mandatory reselection|обязательный повторный отбор|
manual worker|неквалифицированный рабочий|
manufactured goods|промышленные товары|,mxnju'fxktSqd'gudz
manufacturing industry|обрабатывающая промышленность|
many of|многие из|
march through|пройти через|
mass lobby|массовая кампания давления|
mass media|средства массовой информации|
mass meeting|массовый митинг|
mass movement|массовое движение|
mass rally|массовый митинг|
mass unemployment|массовая безработица|
material basis|материальная основа|
mean that|означать|
means of something|средства чего-либо|
measures to do something|меры, направленные на то, чтобы сделать что-либо|
medical officer|медицинский служащий|
medical staff|медицинский персонал|
meet claims|удовлетворять требования|
meet demands|удовлетворять требования|
meet for talks|встречаться для переговоров|
meeting with|встреча с|
member of parliament|член парламента|
mental health|психическое здоровье|
message of support|послание с выражением поддержки|
message to somebody|послание кому-либо|
militant action|энергичные действия|
military activity|военные действия|
military command|военное командование|
military expenditure|военные расходы|
military necessity|военная необходимость|
military spokesman|представитель военного ведомства|
military tribunal|военный трибунал|
mining industry|горнодобывающая промышленность|
minority report|особенное мнение меньшинства|
mobility of labour|подвижность рабочей силы|
mobilize for|мобилизовать на|
more and more|все больше и больше|
more that|более чем|
most of|большинство|
motor industry|автомобильная промышленность|
move a motion|вносить предложение|
move by|предложение|
move into|передвинуться в|
move to do something|предложение сделать что-либо|
move-technician|киномеханик|
much more|гораздо больше|
much of|многое из|
municipal manual worker|муниципальный неквалифицированный рабочий|
municipal worker|муниципальный рабочий|
national Secretary|национальный секретарь|
national conference|национальная конференция|
national congress|национальный съезд|
national executive|национальный исполком|
national lobby of Parliament|национальная кампания давления на парламент|
national newspaper|газета, имеющая распространение по всей стране|
national organizer|национальный организатор|
national security|государственная безопасность|
national strike|общенациональная забастовка|
nationalized industry|национализированная отрасль промышленности|
nationwide television broadcast|телевизионное вещание по всей стране|
nazi camp|концентрационный лагерь|
need for|потребность в|
need to do something|необходимость сделать что-либо|
needed for|необходимый для|
negotiate for|вести переговоры о|
negotiated settlement|мирное урегулирование|
negotiating committee|комиссия для ведения переговоров|
negotiation on|переговоры о|
negotiations for|переговоры о|
next Thursday|в следующий четверг|
next Tuesday|в следующий вторник|
next month|в будущем месяце|
next week|на следующей неделе|
next year|в будущем году|
no doubt|несомненно|
no longer|больше не|
no matter|независимо|
no one|никто|'nquwAn
none of|никто из|
normalization of relations|нормализация отношений|
not only but also|но также|
not only...but|не только...|
now that|теперь|
nuclear energy|ядерная энергия|
nuclear explosion|ядерный взрыв|
nuclear explosive|ядерный заряд|
nuclear power|ядерная держава|
nuclear power plant|атомная электростанция|
nuclear power station|атомная электростанция|
nuclear tests|ядерные испытания|
nuclear weapons|ядерное оружие|
nuclear-free zone|зона, свободная от ядерного оружия|
object to|возражать против|
obstacle to something|препятствие для чего-либо|
obstruct justice|препятствовать правосудию|
of all|изо всех|
of course|конечно|
offer for|предложение за|
oil company|нефтяная компания|
oil crisis|нефтяной кризис|
oil firm|нефтяная фирма|
oil prices|цены на нефть|
old people|старики|
old-age pension|пенсия по старости|
old-age pensioner|пенсионер по старости|
on April 5|5-го апреля|
on January 5|5-го января|
on July 5|5-го июля|
on June 5|5-го июня|
on May 5|5-го мая|
on Monday|в понедельник|
on Saturday|в субботу|
on September 5|5-го сентября|
on Thursday|в четверг|
on Tuesday|во вторник|
on Wednesday|в среду|
on a basis|на основе|
on a charge of|по обвинению в|
on a scale|в размерах|
on average|в среднем|
on behalf of|от имени|
on both sides|по обеим сторонам|
on close examination|при близком рассмотрении|
on duty|дежурный|
on holiday|в отпуске|
on research|на исследовании|
on strike|бастующий|
on television|по телевидению|
on terms|на условиях|
on the basis of something|на основе чего-либо|
on the contrary|наоборот|
on the council|в совете|
on the day|в этот день|
on the eve of|накануне|
on the ground of|на основании|
on the grounds|на том основании|
on the issue of|по вопросу о|
on the matter|по этому вопросу|
on the one hand|с одной стороны|
on the other hand|с другой стороны|
on the question|по вопросу|
on the question of|по вопросу о|
on the spot|на месте|
on the whole|в целом|
on top of|наверху|
once again|еще раз|
once more|еще раз|
one by one|один за другим|
one of|один из|
one-day stoppage|однодневная забастовка|
one-day strike|однодневная забастовка|
open fire|открывать огонь|
open the gate|открывать путь|
open up|открывать|
opportunity for|удобный случай для|
opportunity to do something|возможность сделать что-либо|
oppose to something|противостоять чему-либо|
opposition from somebody|противодействие со стороны кого-либо|
opposition leader|лидер оппозиции|
opposition to something|противодействие чему-либо|
order for|заказ на|
other than|иначе|
out of|из|
over a year|в течение года|
over the period|в течение периода|
overtime ban|запрещение сверхурочных работ|
overwhelming majority|подавляющее большинство|
owing to|благодаря|
parity with|равноправие с|
parliamentary party|парламентская группа партии|
part-time worker|рабочий с неполным рабочим днем|
participate in|участвовать в|
party chairman|председатель партии|
party leader|партийный руководитель|
party meeting|партийное собрание|
party member|член партии|
party official|партийный работник|
party policy|партийная политика|
party programme|партийная программа|
pass a bill|провести законопроект|pQ:s q bIl
pay a visit to|нанести визит|
pay award|денежное вознаграждение|
pay bargaining|заключение коллективных договоров о заработной плате|
pay claim|требование о повышении заработной платы|
pay curb|сдерживание роста заработной платы|
pay deal|соглашение о заработной плате|
pay dispute|конфликт по вопросу о заработной плате|
pay for|платить за|
pay freeze|замораживание заработной платы|
pay increase|увеличение заработной платы|
pay limit|ограничение роста заработной платы|
pay negotiation|переговоры о повышении зарплаты|
pay off|расплатиться|
pay offer|предложение о прибавке зарплаты|
pay packet|пакет с зарплатой|
pay policy|политика в области зарплаты|
pay rises|увеличение заработной платы|
pay settlement|урегулирование вопроса о заработной плате|
pay talks|переговоры об увеличении заработной платы|
pay up|расплатиться|
pay-out|выплата|
peace formula|мирные предложения|
peace talks|мирные переговоры|
peace-keeping force|миролюбивые силы|
per cent|процент|pq'sent
per house|на один дом|
per week|в неделю|
per year|в год|
phone bill|счет за телефон|
pick up|собирать|
picket line|линия пикетчиков|
pit closure|закрытие шахты|
place emphasis on|подчеркивать|
place somebody in something|помещать кого-либо куда-либо|
plan for|планы на|
plan to do something|план сделать что-либо|
play a part|играть роль|
play a role|играть роль|
play into the hands of|играть на руку|
plead guilty|признавать себя виновным|
plead not guilty|не признавать себя виновным|
pledge support|обещать поддержку|
plenty of|множество|
plot to do something|заговор с целью сделать что-либо|
point|точка, пункт|pOInt
point of view|точка зрения|
point out|указывать|
police chief|начальник полиции|
police force|полиция|
police officer|полицейский|
police spokesman|представитель полиции|
police station|полицейский участок|
policy on|политика относительно|
political leader|политический лидер|
political life|политическая жизнь|
political organization|политическая организация|
political party|политическая партия|
political prisoner|политический заключенный|
political trial|политический прогресс|
poll votes|получать голоса|
polling day|день выборов|
popular movement|народное движение|
post office|министерство почт|
post office worker|почтовый работник|
post staff|почтовые работники|
postal office worker|почтовый работник|
postal services|почтовая служба|
potato crisp|хрустящий картофель|
pounce on|нападать на|
power plant|электростанция|
power worker|работник энергетической промышленности|
predict that|предсказывать, что|
prepare for|готовить к|
prepare to do something|готовить сделать что-либо|
present something to somebody|представить что-либо кому-либо|
preside over|руководитель|
press conference|пресс-конференция|
press for|требовать|
press on|оказывать давление на|
pressure for something|требование чего-либо|
pressure group|группа по оказанию давления|
pressure on somebody|давление на кого-либо|
prevent from|предотвратить что-то|
price control|контроль над ценами|
price for something|цена чего-либо|
price freeze|замораживание цен|
price increase|рост цен|
price rises|повышение цен|
prices and incomes policy|политика в области цен и доходов|
primary school|начальная школа|
printworkers' union|профсоюз работников типографий|
prison officer|тюремный служащий|
prison system|тюремная система|
prison treatment|тюремное обращение|
private contractor|частный контрактор|
private detective|частный детектив|
private enterprise|частное предприятие|
private industry|частная промышленность|
private landlord|частный домовладелец|
private sector|частный сектор|
proceed with|продолжать|
production scheme|производственная программа|
profit of|прибыль в|
profits from|прибыли от|
progress in|прогресс в|
progressive movement|прогрессивное движение|
proposal by somebody for something|предложение кого-либо о чем-либо|
proposal for something|предложение о чем-либо|
proposal from somebody|чье-либо предложение|
proposal to do something|предложение сделать что-либо|
propose that|предложить, чтобы|
protect something from|защищать что-либо от|
protest against|протестовать против|
protest by|протест|
protest from|протест со стороны|
prove that|доказывать, что|
provide for something|предусматривать что-либо|
provide somebody with something|обеспечивать кого-либо чем-либо|
public disorders|общественные беспорядки|
public employee|работник общественного обслуживания|
public enterprise|общественное предприятие|
public expenditure|расходы на общественные нужды|
public expenditure cuts|сокращение расходов на общественные нужды|
public health|общественное здравоохранение|'pAblIk'helT
public inquiry|общественное расследование|
public meeting|публичный митинг|
public money|общественные средства|
public opinion|общественное мнение|
public ownership|общественная собственность|
public school|частная привилегированная школа|'pAblIk'sku:l
public sector|общественный сектор|
public service|коммунальное обслуживание|
public service worker|коммунальный работник|
public spending|расходы на общественное обслуживание|
public transport|общественный транспорт|
publicly owned industry|государственная промышленность|
pull down|сносить|
pull out|вытягивать|
pull out of|вытягивать из|
puppet premier|премьер-министр марионеточного правительства|
purchasing power|покупательная способность|'pq:tSqsIN'pauq
push prices up|вздувать цены|
push through|пробивать|
push up|увеличивать|
put an end to|положить конец|
put at risk|подвергать риску|
put forward|выдвигать|
put in|выдвинуть|
put in a difficult position|поставить в трудное положение|
put into effect|осуществить|
put somebody on something|побудить кого-либо к чему-либо|
put up|поднимать|
put up prices|повышать цены|
quality of life|качество жизни|
question of|вопрос о|
race hate|расовая ненависть|
race hatred|расовая ненависть|
radical changes|радикальные изменения|
railway worker|железнодорожник|
range from...to|от...до|
rank-and-file|рядовые|
rather than|а не|
reach agreement on|достигать соглашения о|
react to|реагировать на|
read out|зачитывать|
real wages|реальная зарплата|
realize that|понимать, что|
reason for something|причина чего-либо|
recipe for|рецепт на|
recognize that|признать, что|
recommend that|рекомендовать, чтобы|
recommendation that|совет о том, что|
recruit members|вербовать членов|
reduce to|снизить до|
reduction in something|снижение чего-либо|
refer dispute to a court|передавать спор на рассмотрение суда|
refer to|ссылаться на|
reference to|ссылка на|
reflect in something|отражать в чем-либо|
refusal to do something|отказ сделать что-либо|
refuse somebody something|отказать кому-либо в чем-либо|
refuse to do something|отказаться сделать что-либо|
regard something as something|считать что-либо чем-либо|
regular forces|регулярные войска|
relate to|по отношению к|
relations with|отношения с|
release somebody from prison|выпускать кого-либо из заключения|
release somebody on bail|освободить кого-либо под залог|
relevant to|имеющий отношение к|
religious leader|религиозный лидер|
rely on|полагаться на|
rent assessment committee|комиссия по определению размера арендной платы|
rent increase|рост квартирной платы|
rent officer|служащий арендного управления|
rented property|сдаваемое в наем жилье|
reply to somebody|ответ кому-либо|
report on|доклад о|
report that|сообщать, что|
report to somebody|докладывать кому-либо|
representative from|представитель от|
representative of|представляющий|
request for|просьба о|
resign from|выйти из|
resistance to something|сопротивление чему-либо|
resolution from somebody|чья-либо резолюция|
resolution on|резолюция по вопросу о|
resort to something|обращаться к чему-либо|
respond to something|откликнуться на что-либо|
response from somebody|реакция со стороны кого-либо|
response to|ответ на|
responsibility for|ответственность за|
responsible for|ответственный за|
responsible to somebody|ответственный перед кем-либо|
restraint on|ограничения на|
result in|приводить к|
return of somebody|возвращение кого-либо|
return to something|возврат к чему-либо|
return to work|приступать к работе|
reveal that|предать гласности то, что|
revert to|вернуться к|
right to do something|право совершения чего-либо|
right-wing Labour leader|лидер правых лейбористов|
right-wing leader|лидер правых|
riot police|полицейские силы для подавления массовых выступлений|
rise by|рост на|
rise in prices|рост цен|
rise in something|повышение чего-либо|
road accident|дорожное происшествие|
rule on something|править чем-либо|
rule out|исключить|
run down|настигать|
run into|столкнуться|
run out|кончаться|
safety standard|требования техники безопасности|
satisfied with something|удовлетворенный чем-либо|
save jobs|сохранить рабочие места|
scheme for something|план чего-либо|
school Council|школьный совет учащихся|
school leaver|выпускник школы|'sku:l'li:vq
school milk|бесплатное молоко в школе|
school of Economics|институт экономики|
sea oil|нефть, добываемая со дна моря|
seamen's strike|забастовка моряков|
search somebody for something|обыскивание кого-либо в поисках чего-либо|
second reading|второе чтение|
secondary school|средняя школа|
secretary general|генеральный секретарь|
security forces|отряды службы безопасности|
security of tenure|обеспечение владения|
security services|служба безопасности|
see somebody as|смотреть на кого-либо как на|
seek to do something|требовать выполнения чего-либо|
self-determination|самоопределение|,self dItq:mI'neISn
sell to somebody|продавать кому-либо|
selling price|продажная цена|
send for trial|отдавать под суд|
senior officer|старший чин|
senior shop steward|старший цеховой староста|
sentence somebody to|приговаривать кого-либо к|
serve a life sentence for something|отбывать пожизненное заключение за что-либо|
serve a sentence|отбывать наказание|
set out|помещать|
set something out in something|излагать что-либо в чем-либо|
set up|устанавливать|
setting-up of|составление|
sheet metal worker|жестянщик|
shift in the balance|нарушение равновесия|
shipbuilding industry|судостроительная промышленность|
shoot dead|застрелить|
shoot down|застрелить|
shoot up|подскочить|
shop Steward|цеховой староста|
shop floor meeting|цеховое собрание|
shop steward's committee|комиссия цеховых старост|
shop stewards convener|уполномоченный цеховых старост|
short-term|краткосрочный|
show that|показать, что|
show up|разоблачать|
sign on|нанимать на работу|
similar to something|подобный чему-либо|
single somebody out|выделять кого-либо|
sit down|усаживаться|
skilled worker|квалифицированный рабочий|
so far|до сих пор|
so that|чтобы|
so-called|так называемый|'squ'kO:ld
so...as|так...что|
social contract|"социальный контракт"|
social services|общественное обслуживание|
social worker|работник патронажа|
solidarity with|солидарность с|
solution to something|решение чего-либо|
some|около|sAm
some million|несколько миллионов|
some of|некоторые из|
somebody appears to be|кажется, что кто-либо|
somebody appears to do something|кажется, что кто-либо делает что-либо|
somebody is believed to do something|полагают, что кто-либо делает что-либо|
somebody is known to do something|известно, что кто-либо делает что-либо|
somebody is likely to do something|вероятно, кто-либо сделает что-либо|
somebody is reported to do something|сообщают, что кто-либо делает что-либо|
somebody is said to be|говорят,  что кто-либо является|
somebody is seen to do something|видят, что кто-либо делает что-либо|
somebody is supposed to do something|предполагается, что кто-либо делает что-либо|
somebody is thought to do something|считают, что кто-либо делает что-либо|
somebody is unlikely to do something|маловероятно, что кто-либо сделает что-либо|
somebody seems to be|кажется, что кто-либо является|
somebody seems to do something|кажется, что кто-либо делает что-либо|
somebody would like to do something|кто-либо хотел бы сделать что-либо|
somebodyis expected to do something|ожидается, что кто-либо сделает что-либо|
sort out|сортировать|
spark off|зажигать|
speak against|выступать против|
speak for|выступать за|
speak of|говорить о|
special TUC|специальная конференция БКТ|
special conference|специальная конференция|
speed up|ускорять|
spell out|разбирать по буквам|
spend on|тратить на|
spending on|расходы на|
spokesman for somebody|представитель кого-либо|
spy scare|шпиономания|
staff section|секция личного состава|
stand against|выступать против|
stand by|стоять в стороне|
stand for|защищать|
stand to do something|рассчитывать на то, что будет сделано что-либо|
stand up|вставать|
standard of living|жизненный уровень|
start with|начать с|
state machine|государственная машина|
state of emergency|чрезвычайное положение|
state of mind|настроение|
state of siege|осадное положение|
state that|заявлять, что|
state-owned|принадлежащий государству|
statement by somebody|чье-либо заявление|
statement from somebody|чье-либо заявление|
statement on|заявление о|
statement to somebody|заявление в адрес кого-либо|
stay on strike|продолжать забастовку|
stay out of|отсутствовать|
steel corporation|сталелитейная корпорация|
steel industry|сталелитейная промышленность|
steel worker|работник сталелитейной промышленности|
step down|понижаться в должности|
step toward|шаг по направлению к|
step up|усиливаться|
stick to something|придерживаться чего-либо|
stir up|возбуждать|
stop somebody from something|помешать кому-либо сделать что-либо|
stop work|прекратить работу|
stress that|подчеркнуть, что|
strike action|забастовочные действия|
strike against|бастовать в знак протеста против|
strike by|забастовка|
strike call|призыв к забастовке|
strike committee|забастовочный комитет|
strike craft|боевой корабль|
strike for|забастовка|
strike fund|забастовочный фонд|
strike movement|забастовочное движение|
strong|числом|strON
struggle against|борьба против|
struggle for|борьба за|
student accommodation|жилье для студентов|
student housing|жилье для студентов|
student union|студенческий союз|
subject somebody to something|подчинять кого-либо чему-либо|
subject to|в соответствии|
subject to consent of|с согласия|
submarine base|база подводных лодок|
subsidy on|субсидия на|
succeed in something|добиться успеха в чем-либо|
such as|как например|
suffer from|страдать от|
suggest that|предлагать, что|
sum up|резюмировать|
support for somebody|поддержка кого-либо|
support from somebody|поддержка со стороны кого-либо|
support of somebody|поддержка кого-либо|
supporter of something|сторонник чего-либо|
surrender to somebody|уступка кому-либо|
sympathetic to|сочувствующий|
sympathy for somebody|сочувствие кому-либо|
take a view|принять точку зрения|
take action|предпринимать действия|
take advantage of|использовать|
take away|устранять|
take decision|принять решение|
take effect|оказать действие|
take in|принять|
take industrial action|организовать забастовку|
take into account|принять во внимание|
take line|принять направление|
take measures|принять меры|
take off|взлететь|
take on|принять на работу|
take out|изымать|
take over|захватывать|
take over from somebody|захватывать у кого-либо|
take part|участвовать|
take part in|участвовать в|
take place|происходить|
take stand|занять позицию|
take steps|предпринимать шаги|teIk steps
take up the matter|заниматься делом|
take-off|взлет|'teIkOf
take-over|захват|'teIk,quvq
talk about|разговор о|
talk back|возражать|
talk of|разговор о|
talk to|разговаривать с|
talks on|переговоры о|
talks with|переговоры с|
tax on|налог на|
tax on income|подоходный налог|
taxi driver|водитель такси|
teachers union|профсоюз учителей|
teaching methods|методика обучения|
tear gas|слезоточивый газ|
telephone bill|счет за телефон|
tell a conference|выступать на конференции|
test ban|запрещение испытаний атомного оружия|'testbxn
test ban treaty|договор о запрещении испытаний|
than ever before|чем когда-либо прежде|
thanks to somebody|благодаря кому-либо|
that is why|вот почему|
the Arab World|арабский мир|
the Queen's speech|тронная речь королевы|
the fact that|тот факт, что|
the number of|число|
the only|единственный|
the only one|единственный|
the other day|на днях|
the rest|остальные|
the same|тот же самый|
the three|трое|
the two|оба|
the very|самый|
the whole of|все|
there be|иметься|
think of|думать о|
third largest|третий по величине|
this country|наша страна|
this kind of|этого рода|
this month|в этом месяце|
this morning|сегодня утром|
this week|на этой неделе|
this year|в этом году|
threat against somebody|угроза кому-либо|
threat of something|угроза чего-либо|
threat to somebody|угроза кому-либо|
threaten with something|угрожать чем-либо|
throughout the country|по всей стране|
throughout the world|по всему миру|
throw into|бросать в|
throw out|выбрасывать|
time has come for|настало время для|
time is ripe for|настало время для|
time rate|норма времени|
time-table for something|график чего-либо|
times|раз|
to come extent|до некоторой степени|
to each other|друг другу|
together with|вместе с|
token strike|символическая забастовка|
tomorrow night|завтра вечером|
tour of|поездка по|
trade mission|торговая миссия|'treId'mISqn
trade union|профсоюз|'treId'ju:njqn
trade union and labour movement|профсоюзное и рабочее движение|
trade union committee|профсоюзный комитет|
trade union leader|профсоюзный лидер|
trade union movement|профсоюзное движение|
trade union official|профсоюзный работник|
trade union organization|профсоюзная организация|
trade union representation|представительство профсоюза|
trade union side|профсоюзная сторона|
trade-union branch|отделение профсоюза|
trade-unionism|тред-юнионизм|'treId'ju:njqnIzm
trade-unionist|тред-юнионист|'treId'ju:njqnIst
transfer of engagements|перенос обязательств|
translate into|преобразовывать в|
transport worker|транспортный рабочий|
travelling expense|путевые расходы|
trial of|суд над|
turn down|отклонять|
turn into|превращать в|
turn out|выгонять|
two-tier system|система двух этапов|
typical of|типичный для|
unable to do something|неспособный сделать что-либо|
under an act|согласно закону|
under conditions|в условиях|
under house arrest|под домашним арестом|
under policy|согласно политике|
under pressure|под давлением|
under the terms of|по условиям|
under way|происходящий|
underground tests|подземные испытания|
union branch|отделение профсоюза|
union conference|конференция профсоюза|
union convener|профсоюзный уполномоченный|
union executive|исполком профсоюза|
union leader|профсоюзный лидер|
union member|член профсоюза|
union membership|членство в профсоюзе|
union national executive|Национальный исполком профсоюза|
union official|профсоюзный работник|
union president|президент союза|
union recognition|признание профсоюза|
union representative|представитель профсоюза|
united action|объединенные действия|
unregistered rent|неофициальная плата за квартиру|
up to|до|
urge somebody to do something|вынуждать кого-либо делать что-либо|
urge that|потребовать, чтобы|
use as|использовать в качестве|
vast majority|подавляющее большинство|
views of|взгляды|
views on|взгляды на|
violent crime|тяжелое преступление|
visit to|визит в|
vote against|голосовать против|
vote for|голоса за|
vote on|голосование по вопросу о|
vote somebody|голосовать за кого-либо|
vote to do something|голосовать за то, чтобы сделать что-либо|
wage claim|требование о повышении заработной платы|
wage demands|требования относительно заработной платы|
wage freeze|замораживание заработной платы|
wage increase|увеличение заработной платы|
wage negotiation|переговоры о повышении зарплаты|
wage packet|зарплата|
wage restraint|сдерживание зарплаты|
wage rises|увеличение заработной платы|
wage-vetting bill|законопроект о пересмотре ставок заработной платы|
wages agreement|соглашение по вопросу о заработной плате|
wages deal|соглашение о заработной плате|
wages policy|политика в области зарплаты|
wake up|пробуждаться|
walk down|прогуливаться по|
walk out|бастовать|
warn of|предупреждать о|
warn on|предупреждать о|
warn that|предупреждать, что|
warning of|предупреждение о|
waste on|напрасно тратить на|
way forward|путь вперед|
week old|недельный|
week wage|недельная зарплата|
well-known|хорошо известный|
white man|белый человек|
white youth|белая молодежь|
wind up|заканчивать|
with regard to|что касается|
with the aim of|с целью|
withdraw from|отказаться от|
withdrawal from|уход из, вывод из |
withdrawal of|вывод|
woman worker|работница|
women's liberation movement|женское освободительное движение|
women's opposition|угнетение женщин|
work against|действовать против|
work for|работать в пользу|
work force|рабочая сила|
work on|работать над|
work out|разрабатывать|
work to rule|работать "по правилам"|
work toward|действовать в направлении|
work-to-rule|работа "по правилам"|
working class|рабочий класс|'wq:kIN'klQ:s
working class movement|рабочее движение|
working group|рабочая группа|
working hours|рабочее время|
working people|трудящиеся|'wq:kIN,pi:pl
working week|рабочая неделя|
working woman|работница|
world market|мировой рынок|
world peace|мир во всем мире|
world war|мировая война|
worry about|беспокоиться о|
year after|год за годом|
year old|прошлогодний|
yesterday afternoon|вчера после полудня|
yesterday morning|вчера утром|
young black|темнокожий юноша|
young people|молодежь|
youth committee|молодежный комитет|
youth conference|молодежная конференция|
youth organization|молодежная организация|
