abandon|оставлять, покидать|q'bxndqn
accept|принимать, признавать, соглашаться|qk'sept
accomplish|выполнять, завершать|q'kAmplIS
accumulate|накапливать, аккумулировать|q'kju:mjuleIt
achieve|достигать, добиваться|q'CJv
act|действовать, поступать |xkt
adapt|приспособить, адаптировать|q'dxpt
add|прибавлять, добавлять|xd
address|адресовать, направлять|q'dres
administer|управлять, вести дела, назначать|qd'mInIstq
admit|признавать, допускать, впускать|q'dmIt
adopt|принимать, усыновлять, удочерять|q'dPpt
adore|обожать, поклоняться|q'dL
advance|продвигаться|qd'vRns
advise|советовать|qd'vaIz
affirm|подтверждать, утверждать|q'fE:m
agree|соглашаться|q'gri:
aid|помогать, оказывать помощь|eId
allow|позволять, разрешать|q'lau
amuse|развлекать|q'mju:z
analyse|анализировать|'xnqlaIz
anounce|объявлять, заявлять|q'nauns
answer|отвечать|'Rnsq
apologize|извиняться|q'pPlqGaIz
appear|появляться|q'pIq
approach|подходить, приближаться|q'prquC
argue|спорить|'Rgju:
arrive|прибывать, приезжать|q'raIv
ask|спрашивать|Rsk
assist|помогать|q'sIst
awake|будить|q'weIk
award|награждать|q'wLd
back|поддерживать|bxk
bake|выпекать|beIk
balance|балансировать|'bxlqns
ban|запрещать|bxn
bandage|бинтовать|'bxndIG
bang|ударить|bxN
be|быть, находится|bJ
bear|терпеть, выносить|beq
become|становится, превращаться|bI'kAm
beg|просить|beg
begin|начинать|bI'gIn
behave|вести себя|bI'heIv
belive|верить|bI'lJv
belong|принадлежать|bI'lPN
benefit|приносить пользу; извлекать пользу|'benqfIt
bet|держать пари|bet
bite|кусать, жалить|baIt
bless|благословлять|bles
blow|дуть, раздувать|blqu
boast|похвастаться|bqust
book|бронировать, заказывать|buk
break|ломать, прерывать|breIk
bring|приносить, приводить|brIN
brush|чистить щеткой|brAS
care|заботиться|keq
carry|носить|'kxri
catch|поймать, схватить|kxC
cause|вызывать, причинять|kLz
celebrate|праздновать, отмечать|'selIbreIt
change|менять, изменять|CeInG
choose|выбирать|CHz
clean|очищать|klJn
climb|взбираться, влезать|klaIm
close|закрывать|klquz
come|приходить, приезжать|kAm
compare|сравнивать|kqm'peq
complain|жаловаться|kqm'pleIn
conceal|скрывать, прятать|kqn'sJl
consider|рассматривать, обдумывать|kqn'sIdq
copy|копировать|'kPpi
cross|пересекать|krPs
cut|резать|kAt
dance|танцевать|dRns
decide|решать|dI'saId
decorate|украшать, декорировать|'dekqreIt
defend|защищать|dI'fend
deny|отрицать, отвергать|dI'naI
depend|зависеть|dI'pend
describe|описывать, изображать|dI'skraIb
destroy|уничтожить|dI'strOI
determine|определять|dI'tE:mIn
disappear|исчезать, скрываться|"dIsq'pIq
discover|открывать, делать открытие|dIs'kAvq
divide|разделить|dI'vaId
do|делать|dH
doubt|сомневаться|daut
draw|рисовать; тащить, волочить|drL
drive|вести, водить|draIv
drop|ронять |drPp
earn|зарабатывать|E:n
elect|выбирать, избирать|I'lekt
end|заканчивать|end
enjoy|получать удовольствие|In'GOI
enter|вступать в, входить в|'entq
estimate|оценивать|'estImeIt
examine|проверить, экзаменировать|Ig'zxmIn
exchange|менять, обменивать|Iks'CeInG
exclaim|восклицать|Ik'skleIm
excuse|извинять, прощать|Ik'skju:z
expect|ожидать|Ik'spekt
explain|объяснять|Ik'spleIn
face|стоять/сидеть лицом к |feIs
fail|проваливаться, терпеть неудачу|feIl
fall|падать|fLl
fetch|принести, привести|feC
fight|сражаться|faIt
finish|завершать|'fInIS
fly|летать|flaI
follow|следовать|'fPlqu
forget|забывать|fq'get
forgive|прощать, простить|fq'gIv
fulfil|выполнять, исполнять|ful'fIl
gain|получать; приобретать|geIn
gather|собирать, созывать|'gxDq
get|получать, доставать|get
give|давать, дарить|gIv
go|идти, ходить, ехать, лететь, плыть|gqu
graduate|окончить (ВУЗ....)|'grxGueIt
greet|приветствовать, кланяться|grJt
grow|расти|grqu
guarantee|гарантировать|"gxrqn'tJ
guess|отгадывать|ges
hand|вручать, передавать|hxnd
hang|вешать|hxN
hate|ненавидеть|heIt
have|иметь, обладать|hxv
hear|слушать|hIq
help|помогать|help
hesistate|колебаться|'hezIteIt
hide|прятать|haId
hold|держать|hquld
hope|надеяться|hqup
hurt|причинять боль|hE:t
imagine|представлять себе|I'mxGIn
improve|улучшать|Im'prHv
increase|увеличивать|In'krJs
influence|влиять|'Influens
interrupt|прерывать|"Inte'rApt
investigate|исследовать, рассматривать|In'vestIgeIt
invite|приглашать|In'vaIt
jingle|звенеть|GINgl
join|соединять|GOIn
joke|шутить|dZquk
judge|судить|GAG
jump|прыгать|GAmp
justify|оправдывать|'GastIfaI
keep|хранить|kJp
kick|ударять ногой|kIk
kill|убивать, ликвидировать|kIl
kiss|целовать|kIs
knock|стучать|nPk
know|знать|nqu
last|длиться|lRst
laugh|смеяться|lRf
lead|вести|lJd
leave|покидать|lJv
let|позволять, разрешать|let
lie|лежать|laI
like|нравиться, любить|laIk
listen|слушать|lIsn
live|жить|lIv
lose|терять|lHz
make|делать|meIk
meet|встречать|mJt
mend|чинить|mend
miss|упускать; опаздывать на ...|mIs
mix|мешать, смешивать|mIks
move|двигать|mHv
name|называть|neIm
need|нуждаться|nJd
neglect|пренебрегать|nI'glekt
nod|кивать головой|nPd
note|замечать|nqut
notice|замечать, уведомлять|'nqutIs
notify|извещать|'nqutIfaI
number|нумеровать|'nAmbq
nurse|нянчить|'nE:s
obey|слушаться|'qubeI
object|возражать|'qbdZIkt
offend|обижать, оскорблять|q'fend
offer|предлагать|'Pfq
open|открывать|'qupqn
operate|управлять (станком и т.п.)|'PpqreIt
order|заказывать; приказывать|'Ldq
organize|организовывать|'LgqnaIz
paint|рисовать|peInt
pass|проходить|pRs
pay|платить|peI
perform|исполнять|pq'fLm
pick|собирать, срывать|pIk
plan|планировать|plxn
plant|сажать, внедрять|plRnt
play|играть|pleI
point|указывать|pOInt
pour|наливать|pL
promise|обещать|'prPmIs
propose|предлогать, вносить предложение|prq'pquz
prove|доказывать|prHv
pull|тянуть, тащить|pul
punish|наказывать|'pAnIS
push|толкать|puS
put|класть|put
puzzle|озадачивать, поражать|pAzl
quarrel|ссориться|'kwPrql
question|расспрашивать, допрашивать|'kwesCqn
quicken|ускорять, оживлять|'kwIkqn
quiet|успокаивать|kwaIqt
quit|оставлять, покидать|kwIt
quiver|дрожать, трепетать|'kwIvq
quote|цитировать|kwqut
reach|протягивать, вытягивать|rJC
read|читать|rJd
recieve|получать, принимать|rI'sJvq
recite|декламировать|rI'saIt
refuse|отказывать|rI'fjHz
regret|сожалеть|rI'gret
remain|оставаться|rI'meIn
remember|помнить, запомнить|rI'membq
remind|напоминать|rI'maInd
repeat|повторять|rI'pJt
reply|отвечать|rI'plaI
report|докладывать|rI'pLt
rest|отдыхать, лежать|rest
ring|звенеть|rIN
rise|поднимать; вставать|raIz
run|бежать|rAn
save|спасать, беречь|seIv
say|говорить, сказать|seI
sell|продавать|sel
send|посылать|send
sew|шить, зашивать|squ
shine|светить|SaIn
shiver|трястись|'SIvq
shut|закрыть|SAt
sign|подписывать|saIn
sing|петь|sIN
sit|сидеть|sIt
skate|кататься на коньках|skeIt
ski|кататься на лыжах|skJ
sleep|спать|slJp
smile|улыбаться|smaIl
spell|писать по буквам|spel
spend|тратить|spend
spread|распространять|spred
stand|стоять;  выдержать|stxnd
struggle|бороться|strAgl
study|изучать|'stAdi
suppose|предполагать|sq'pquz
swallow|глотать|'swPlqu
swear|клясться, присягать|sweq
switch|переключать|swIC
take|брать, взять|teIk
talk|говорить|tLk
taste|пробовать|teIst
tease|дразнить|tJz
tell|рассказывать|tel
thank|благодарить|TxNk
think|думать|TINk
train|обучать, тренировать|treIn
travel|путешествовать|'trxvl
treat|обращаться (с кем-либо), лечить|trJt
trouble|беспокоить, тревожить|trAbl
turn|поворачивать|tE:n
use|использовать|jHz
value|оценивать|'vxljH
vex|раздражать|veks
visit|навещать, посещать|'vIzIt
vote|голосовать|vqut
wait|ожидать|weIt
wake|просыпаться|weIk
want|хотеть|wPnt
wash|стирать|wPS
wear|носить|weq
win|выиграть|wIn
work|работать|wE:k
write|писать|raIt
